word,rock,jazz,alternative rock,eletronic,pop,total
raining,3,3,1,2,2,11
ramne,1,1,0,1,1,4
tlfm,1,1,0,1,1,4
yellow,5,1,4,5,4,19
narcotic,1,0,1,1,0,3
four,6,3,1,4,4,18
woods,1,1,0,1,2,5
spiders,1,1,0,0,0,2
mirage,0,0,0,1,0,1
marching,2,1,0,2,0,5
otra,2,0,0,1,2,5
dustland,1,0,1,0,1,3
arriesgarnos,0,0,0,0,1,1
lore,0,0,0,0,1,1
lord,9,10,2,6,11,38
swivel,1,1,0,1,1,4
callin,1,0,0,0,0,1
freeword,1,0,0,0,0,1
oceans,1,1,1,1,0,4
travellin,2,1,1,0,1,5
oceano,1,0,1,0,1,3
screaming,2,0,1,0,0,3
basics,1,0,1,1,1,4
decima,0,1,0,0,0,1
jihad,1,0,0,0,0,1
koronoko,1,1,1,1,1,5
oooh,0,1,0,0,0,1
pivo,1,0,0,1,0,2
merengue,0,0,0,0,1,1
caramelo,1,0,0,1,0,2
tired,3,1,0,1,0,5
garraud,0,1,0,1,1,3
hanging,1,0,0,0,1,2
second,6,5,4,3,6,24
glassi,1,1,1,1,1,5
shuile,0,0,0,1,1,2
tirez,1,1,1,1,1,5
soave,1,0,0,1,0,2
dynamit,0,0,0,1,1,2
thunder,2,1,0,0,2,5
boogie,4,6,0,1,1,12
fingers,3,2,2,3,3,13
roadhouse,1,1,0,0,1,3
essaywhuman,0,1,0,1,1,3
hero,3,0,1,0,2,6
schmerzensschreie,1,0,0,0,0,1
eunice,1,0,0,0,1,2
here,27,12,10,12,22,83
chinz,1,1,1,1,1,5
herz,3,1,0,3,4,11
china,1,2,0,1,2,6
megalodon,1,1,0,0,0,2
gayee,0,0,0,1,0,1
kids,3,1,1,1,4,10
merrygoround,2,2,2,0,1,7
nomades,1,1,0,1,1,4
natures,1,1,0,1,1,4
juras,1,0,0,0,1,2
rebel,2,2,0,0,2,6
golden,5,3,1,5,4,18
roadrunner,1,0,0,0,1,2
kenourgia,1,0,0,0,1,2
slivery,1,0,0,0,0,1
ressuscits,0,1,0,1,0,2
nessum,1,0,0,1,0,2
spoke,1,1,0,0,1,3
cannibal,1,0,0,0,1,2
symphony,1,1,1,1,2,6
music,25,17,15,21,19,97
mystic,1,1,1,1,1,5
strike,1,1,1,1,1,5
until,5,4,3,4,5,21
imparable,1,0,0,0,1,2
playboy,1,1,0,1,1,4
holy,2,1,0,1,2,6
relax,0,0,0,1,1,2
brings,1,0,1,0,0,2
gedroomd,1,1,1,0,1,4
pasta,1,0,0,1,1,3
machinenfunk,1,0,0,1,0,2
hurt,1,2,1,0,2,6
glass,1,1,0,0,0,2
holi,1,0,1,2,1,5
hole,6,4,3,4,5,22
hold,20,8,7,15,19,69
doppelgnger,1,0,1,1,0,3
hola,1,1,0,1,0,3
circumstances,1,0,0,0,0,1
evigne,1,1,0,1,1,4
locker,1,1,1,1,1,5
sweeter,1,1,1,0,1,4
matilda,1,2,0,1,3,7
wang,0,2,0,1,4,7
dyks,1,1,0,1,1,4
titanium,1,0,0,1,1,3
caution,1,1,0,1,1,4
want,21,10,12,20,23,86
salamanders,1,1,0,0,1,3
somebodys,3,0,0,0,1,4
absolute,2,0,1,1,1,5
cielo,1,0,1,1,0,3
travel,4,0,1,2,2,9
seuraavassa,1,0,1,1,1,4
damage,1,1,1,1,1,5
machine,7,0,3,5,6,21
louisville,1,0,0,0,1,2
machina,1,1,1,1,1,5
eimsbush,0,0,0,1,0,1
cadence,1,1,0,1,0,3
grazon,1,1,1,1,1,5
moritat,1,1,0,0,1,3
beauty,8,1,2,6,7,24
wilakuy,0,0,0,0,1,1
stravinsky,0,0,0,0,2,2
ryders,1,0,0,0,1,2
shores,1,0,0,0,1,2
wrong,7,3,2,2,6,20
destined,1,0,0,0,0,1
ouroboros,1,0,1,0,0,2
scourge,1,0,1,1,1,4
buzzs,0,0,1,0,0,1
baggage,1,1,1,1,1,5
keeps,1,1,1,1,2,6
wing,2,1,0,1,2,6
wind,7,9,3,7,8,34
wine,1,0,1,2,2,6
peux,1,1,1,1,1,5
boire,0,0,0,1,1,2
peut,0,0,0,1,0,1
dejes,0,1,0,0,0,1
virgen,0,1,0,1,0,2
dreamer,1,1,0,1,0,3
cumpagno,1,0,0,1,1,3
ruta,1,0,0,0,1,2
survivors,1,0,1,1,0,3
hidden,5,2,1,4,3,15
glorify,1,0,1,0,1,3
thrones,0,0,1,0,0,1
biding,1,0,1,0,1,3
jamalo,1,1,1,1,1,5
sixteen,1,1,1,1,0,4
silver,6,3,1,5,5,20
rumour,1,1,1,1,1,5
disconnection,1,0,0,0,1,2
eoghain,1,1,0,1,1,4
chinoiserie,0,1,0,1,0,2
spider,1,0,1,1,1,4
solution,1,0,0,0,1,2
contracting,1,1,1,1,1,5
cathedral,1,0,0,1,1,3
blinded,1,1,1,1,1,5
whip,2,0,1,3,1,7
romntico,0,1,0,0,0,1
toute,1,0,0,0,0,1
urbans,0,0,0,0,1,1
outburst,1,0,1,0,0,2
clarence,1,1,0,0,1,3
knig,1,0,0,1,1,3
sensory,1,0,1,1,1,4
efialtis,1,0,0,0,1,2
estimate,1,1,0,0,0,2
cornerstone,1,1,0,1,1,4
bateu,1,1,0,1,0,3
iceman,1,1,0,0,1,3
villes,1,0,0,0,1,2
gouldagnes,0,1,0,0,1,2
chitlins,1,0,0,0,0,1
holbrook,1,0,0,0,1,2
veggie,1,1,1,1,1,5
channels,0,0,0,1,1,2
wash,2,2,1,2,2,9
dpaves,1,1,0,0,0,2
sensazioni,0,1,0,0,0,1
windmills,1,2,0,2,1,6
lectro,1,1,0,0,1,3
reuben,1,1,0,0,1,3
tango,5,2,1,3,5,16
stack,0,0,0,0,1,1
reginella,1,0,0,0,0,1
master,5,4,2,4,2,17
pierrade,1,1,1,1,1,5
scandalon,0,0,0,0,1,1
legs,1,0,1,1,1,4
genesis,2,0,1,1,0,4
listen,1,1,0,1,1,4
summerfish,0,0,0,1,1,2
juventud,1,1,0,0,1,3
supertouchshitfit,1,0,0,0,0,1
crawl,1,1,1,1,1,5
amsterdamaged,1,0,1,0,0,2
icicle,1,0,1,1,1,4
mercato,0,0,0,0,1,1
coward,1,0,0,0,0,1
tree,5,2,1,2,6,16
yodelling,1,1,0,1,1,4
nations,0,0,0,1,0,1
project,1,1,1,1,1,5
ahmet,1,1,0,0,1,3
tres,1,1,0,1,0,3
feeling,4,4,2,3,3,16
heyya,0,0,0,2,2,4
este,0,0,0,1,1,2
esta,1,1,1,0,1,4
boston,3,2,1,0,2,8
sparnuotoji,1,0,0,0,0,1
juneau,1,0,0,0,0,1
onono,1,1,1,1,1,5
bawlz,1,0,1,1,1,4
novakane,2,0,0,0,0,2
soaked,1,0,1,0,0,2
dixime,1,1,0,1,1,4
himlen,0,1,0,0,0,1
matriarch,1,1,0,1,0,3
shall,0,1,0,0,0,1
doin,2,2,0,2,1,7
object,1,2,1,1,2,7
mouth,2,1,0,1,1,5
letter,3,4,0,2,3,12
dois,1,0,0,0,0,1
thriller,1,0,1,1,1,4
singer,1,1,1,1,1,5
episode,1,1,0,1,1,4
pome,1,1,1,1,1,5
matins,1,1,0,1,1,4
camp,0,1,0,1,1,3
cumbia,0,0,0,0,1,1
tech,0,0,1,0,0,1
bartholdis,0,1,0,1,0,2
mensaje,1,1,0,0,0,2
scream,1,1,1,2,1,6
came,8,4,3,5,6,26
marvel,1,1,1,1,1,5
silber,1,0,0,1,0,2
bomb,4,1,3,3,3,14
bonnie,2,1,1,2,2,8
ulcer,1,0,0,1,1,3
pris,1,1,0,0,1,3
rusticana,1,1,1,1,1,5
orleans,2,3,0,2,2,9
teasin,1,1,2,1,0,5
busy,0,0,0,1,0,1
doilea,1,0,0,1,0,2
louise,3,2,1,1,3,10
telegrama,1,1,1,1,1,5
cupid,1,0,1,0,0,2
bush,1,1,0,1,1,4
bliss,1,1,0,2,1,5
rich,1,0,0,0,1,2
rice,2,0,1,1,2,6
kablammin,1,1,1,1,1,5
plate,1,0,1,1,1,4
rmer,1,1,0,1,1,4
plati,1,0,1,1,1,4
terrors,1,0,0,0,0,1
pocket,3,0,2,1,2,8
danse,1,1,1,1,1,5
kurrajong,1,1,0,1,0,3
jaguar,0,1,0,1,1,3
saylarvee,1,0,1,0,1,3
release,2,0,0,2,1,5
fait,0,0,0,1,0,1
alsina,1,0,0,1,0,2
bagad,1,0,1,1,1,4
beso,1,1,0,1,1,4
fair,4,2,0,1,2,9
melodioso,0,0,0,1,0,1
goodnight,2,1,1,1,1,6
fail,1,0,0,0,1,2
hammer,3,0,2,0,4,9
best,7,1,0,4,5,17
sombrero,1,1,0,0,1,3
sista,1,1,1,1,1,5
blancas,0,1,0,0,0,1
wage,1,0,1,1,1,4
nature,2,2,2,1,2,9
zavelow,1,0,1,0,1,3
defiance,1,0,1,1,0,3
carbon,0,1,0,0,0,1
roller,1,0,0,1,1,3
drei,0,0,0,0,2,2
country,6,3,1,2,5,17
questo,1,1,0,2,1,5
lookin,2,2,1,2,2,9
barchetta,1,1,0,1,0,3
salario,0,0,1,1,0,2
gopher,1,1,1,1,1,5
gypsies,1,0,0,0,1,2
canyon,1,1,0,2,0,4
thoneicks,0,0,1,1,1,3
camisa,1,1,0,0,1,3
humming,1,1,0,0,1,3
niyi,1,0,1,1,0,3
matti,1,0,0,1,1,3
union,1,0,0,0,1,2
savin,1,0,1,0,1,3
much,13,6,7,8,11,45
menutha,1,0,0,1,1,3
stadium,1,1,1,1,1,5
privilege,3,0,0,0,0,3
life,41,17,15,25,32,130
electrocution,1,1,1,1,1,5
moneyg,1,0,0,1,1,3
spit,1,0,1,0,0,2
cuna,1,0,1,0,0,2
worker,1,1,1,1,1,5
wish,10,3,6,6,9,34
dave,2,1,1,2,2,8
lift,1,0,1,1,0,3
cheveux,0,0,0,0,1,1
chile,3,2,0,1,1,7
child,6,4,4,8,5,27
spin,2,0,1,1,1,5
wildcat,1,1,0,0,1,3
lurkin,0,0,0,0,1,1
volveras,0,0,0,1,1,2
player,1,1,0,2,1,5
celos,0,0,0,0,1,1
judys,0,1,0,0,0,1
madonna,1,0,1,1,0,3
ogni,1,1,1,1,1,5
pawnshop,1,0,0,0,1,2
portobello,0,1,0,0,0,1
things,10,10,3,9,12,44
split,1,0,1,2,1,5
drugam,0,1,0,0,0,1
agapas,1,0,0,0,1,2
electro,2,1,1,2,2,8
junge,1,1,0,1,1,4
european,1,0,0,1,1,3
gabry,1,1,1,1,1,5
memoria,0,1,0,1,0,2
marches,1,1,0,0,0,2
haggard,1,0,0,0,0,1
tune,1,0,1,0,0,2
charon,1,0,1,0,0,2
acoustics,1,1,1,1,1,5
poobah,1,1,1,0,0,3
eagle,0,0,1,0,0,1
melodica,0,0,0,0,1,1
dikos,1,0,0,1,1,3
autobahn,1,0,0,1,1,3
mopao,1,1,1,1,1,5
denk,0,0,0,0,1,1
givin,1,1,1,0,1,4
quasar,1,1,0,1,1,4
sleepy,2,2,1,2,2,9
praieiro,0,1,0,1,0,2
birmingham,2,0,0,2,2,6
trong,1,1,0,1,1,4
ease,1,0,1,1,1,4
topical,1,0,0,0,1,2
sofrimento,0,1,0,1,1,3
easy,8,3,3,2,6,22
prison,1,1,1,1,1,5
nelly,1,0,0,0,1,2
east,0,4,2,4,0,10
quune,1,0,1,1,0,3
wiht,1,0,0,1,1,3
shadow,3,1,0,0,2,6
depressionista,1,0,0,0,0,1
sleuthing,1,1,0,0,1,3
bridgehouse,1,0,0,0,0,1
bobby,1,0,0,0,0,1
stepn,1,1,1,1,0,4
complexe,0,0,1,1,0,2
steps,1,1,0,1,2,5
prologue,1,1,0,0,1,3
sebastian,0,0,1,0,0,1
surf,3,1,2,3,1,10
right,13,7,4,8,11,43
creek,1,1,1,1,0,4
crowd,1,1,1,1,1,5
people,18,9,6,19,18,70
teppo,1,0,0,1,1,3
warbox,1,1,0,0,1,3
crown,1,1,0,1,0,3
bereit,1,0,1,1,0,3
trombone,2,2,2,0,0,6
creep,1,1,1,1,1,5
snakebit,1,0,0,0,1,2
bottom,6,3,2,3,4,18
marseilles,1,0,1,1,0,3
lluvias,0,1,0,1,0,2
pestilence,1,0,0,0,0,1
losing,6,3,2,2,7,20
chailleach,0,0,0,1,0,1
valium,1,1,0,1,0,3
spaceships,1,0,0,1,1,3
filipino,1,1,0,0,1,3
walrus,1,1,1,1,1,5
dollars,1,0,0,1,0,2
oneness,1,1,1,1,0,4
nirai,1,0,0,0,0,1
nixon,1,1,1,0,1,4
raised,1,1,0,1,1,4
marshall,1,0,0,1,1,3
honeymoon,1,1,0,0,1,3
thankful,1,0,1,0,1,3
inhume,1,0,1,0,0,2
mambo,6,8,0,4,8,26
wrap,1,0,0,1,0,2
support,0,0,0,1,0,1
constantly,2,0,2,0,2,6
jetstream,1,0,0,1,1,3
nova,2,1,1,2,1,7
width,1,1,0,1,1,4
spring,1,1,1,1,0,4
jane,1,0,1,2,1,5
happy,13,6,4,7,13,43
forming,1,1,1,1,0,4
tigers,2,1,1,1,1,6
back,37,21,14,30,29,131
ltimo,0,2,0,0,0,2
verde,1,1,1,1,0,4
verdi,1,0,0,1,0,2
canbales,1,0,0,0,1,2
inside,6,1,4,1,6,18
confessin,1,0,0,0,1,2
peso,1,1,1,0,0,3
mighty,2,2,1,2,2,9
ormhxan,1,0,0,1,1,3
rerub,1,0,0,1,1,3
juvenile,1,0,0,0,1,2
later,1,1,1,0,0,3
disgrace,1,0,1,1,0,3
gemini,1,0,0,1,1,3
jocastae,0,0,0,0,1,1
kandiyohi,1,0,1,0,1,3
telepathyted,1,0,0,0,0,1
floor,3,2,0,4,3,12
republic,1,1,0,2,1,5
sunset,1,1,1,1,2,6
roll,12,3,5,10,10,40
rolo,1,1,0,1,1,4
reggae,6,6,4,5,1,22
aroundcomes,1,1,0,0,1,3
palms,1,0,1,1,1,4
agnus,1,0,1,0,1,3
devon,1,1,0,1,1,4
intent,1,0,0,1,0,2
chiuse,1,0,0,1,0,2
rolling,1,0,1,3,1,6
puss,0,1,0,0,0,1
cootchie,1,0,0,1,0,2
toktok,1,0,1,1,1,4
lingan,1,1,0,1,1,4
push,2,2,1,4,4,13
cincinnati,1,0,0,0,1,2
chain,2,1,1,1,1,6
maldito,0,0,0,1,0,1
chair,3,1,2,0,2,8
venice,1,1,1,0,1,4
dimelo,0,0,0,0,1,1
decir,0,0,0,1,2,3
himalaya,0,1,0,0,0,1
chokechain,1,0,1,1,1,4
exogenesis,1,1,1,1,1,5
dinicolo,1,0,0,1,0,2
llegaste,0,0,0,1,0,1
mouri,1,0,0,0,1,2
minuto,1,1,0,0,1,3
stays,1,0,1,0,1,3
jeru,0,1,0,0,0,1
locked,2,2,2,0,2,8
minute,1,1,1,1,0,4
cintura,1,1,0,1,1,4
knockin,1,0,0,1,1,3
solver,1,0,1,0,0,2
tear,3,4,3,4,3,17
maha,0,0,0,1,0,1
leave,3,2,3,2,4,14
stockade,1,1,0,0,0,2
team,1,1,0,0,0,2
karottensaft,1,0,1,1,0,3
spiritual,1,1,1,1,1,5
attic,2,0,1,2,2,7
cheree,0,1,0,1,1,3
boca,1,2,0,1,1,5
sign,1,1,2,1,1,6
droit,1,0,1,1,1,4
pienso,1,0,0,0,1,2
crescent,1,0,1,1,1,4
corazon,3,1,0,0,4,8
maschera,1,0,0,1,0,2
chimichanga,1,0,1,1,1,4
vengo,1,0,0,0,1,2
freaks,1,0,1,1,1,4
falling,9,8,5,7,8,37
mela,0,0,1,1,0,2
freaky,1,2,1,1,1,6
mele,1,1,1,1,1,5
vankina,1,0,0,1,1,3
honour,0,1,0,1,0,2
funeral,1,0,1,1,1,4
lange,0,1,0,1,0,2
understanding,0,0,0,1,1,2
alone,16,8,10,9,11,54
along,4,2,0,3,5,14
viaje,1,0,0,1,1,3
benson,0,0,0,1,1,2
terrence,1,1,0,0,1,3
cette,1,0,0,0,0,1
brazilian,0,2,0,0,0,2
jammin,1,1,1,1,1,5
studies,0,0,0,2,0,2
love,224,137,97,156,213,827
roorasty,1,0,0,0,0,1
mnchengladbach,1,0,0,1,1,3
bloody,2,1,0,1,1,5
fake,2,1,2,1,2,8
mihodina,1,1,0,1,1,4
bended,0,0,0,0,1,1
working,1,1,0,0,1,3
homesick,1,1,1,1,1,5
wicker,1,0,1,0,1,3
angry,2,1,2,0,1,6
fortway,1,0,1,1,1,4
charlies,0,0,0,0,1,1
wondering,1,1,0,2,1,5
wicked,2,1,1,0,2,6
marbles,1,1,1,0,0,3
claus,3,3,0,2,2,10
reprise,7,4,2,3,6,22
oregon,1,1,1,1,1,5
everywhere,2,0,2,1,2,7
riders,0,1,0,1,0,2
nastrond,1,0,0,1,0,2
originally,5,0,1,0,0,6
pretend,1,0,0,0,1,2
believer,0,0,0,1,0,1
believes,1,0,1,0,1,3
zhan,0,0,0,0,1,1
following,0,0,0,0,1,1
tuviera,1,0,1,0,0,2
ammonite,1,0,1,1,0,3
fingevo,1,0,0,0,1,2
profecias,1,0,1,1,1,4
graduation,1,0,1,0,1,3
allowed,1,0,0,0,0,1
goofus,0,1,0,1,1,3
ngai,0,1,0,0,0,1
savoy,0,1,0,1,1,3
winter,3,3,4,3,3,16
helden,1,1,0,0,1,3
coyotes,1,1,1,0,1,4
kenourgios,0,0,1,0,1,2
immune,1,0,1,1,0,3
elephant,1,0,1,0,0,2
gayas,1,1,1,0,1,4
snaps,1,1,0,0,0,2
nell,1,1,0,1,1,4
laundry,1,0,0,0,1,2
spot,2,2,1,2,2,9
date,4,3,2,3,4,16
such,1,0,2,1,0,4
suck,2,1,0,1,2,6
revealed,0,0,0,1,1,2
natural,2,3,0,2,2,9
belial,1,0,0,0,0,1
truck,1,0,0,1,1,3
wolves,1,0,1,1,2,5
dreamland,1,0,1,1,1,4
blowup,1,1,1,1,1,5
fencibles,0,1,0,1,1,3
pettenami,0,1,0,0,1,2
kong,2,1,1,2,2,8
course,1,0,0,0,0,1
encantadora,0,1,0,0,0,1
kanye,1,3,0,0,1,5
auguri,1,1,0,1,1,4
dropoff,1,0,1,0,0,2
tule,2,0,1,2,2,7
garbage,2,1,0,1,1,5
troubles,2,1,1,1,1,6
guarare,2,2,0,2,2,8
attraction,0,0,1,1,0,2
thump,0,0,0,1,0,1
limbo,1,0,0,0,1,2
smarter,1,1,0,0,1,3
feelin,3,1,1,3,3,11
reckoning,1,0,1,1,0,3
twilight,1,0,0,1,1,3
cachito,1,0,0,0,1,2
hickory,1,1,0,0,1,3
ladysmith,1,1,0,0,1,3
caminar,1,0,0,0,1,2
quarter,3,1,1,2,0,7
quartet,3,1,0,2,0,6
sunriseprayerjoysunset,0,0,0,1,0,1
turtle,1,1,0,1,0,3
square,1,3,1,0,1,6
revised,1,1,0,0,1,3
concertino,1,1,1,0,0,3
remembrance,1,0,0,0,1,2
container,1,1,1,1,1,5
sachmagehtsnoch,1,0,1,1,1,4
pieuvre,1,0,0,1,1,3
facedown,1,1,1,0,1,4
huevos,1,0,0,0,1,2
poema,1,2,0,1,2,6
allstar,1,1,1,1,1,5
plea,1,0,0,1,0,2
seventy,1,0,0,0,1,2
brasil,1,2,0,1,1,5
artistes,1,0,0,1,1,3
punk,3,0,1,1,1,6
dunns,0,0,1,1,0,2
horas,1,0,0,1,2,4
rompan,1,0,0,1,0,2
expolodera,0,0,0,1,1,2
spoken,4,0,2,0,2,8
potter,0,0,0,2,0,2
mucho,1,0,0,1,1,3
spanish,5,3,2,5,3,18
geheimrezept,1,0,1,1,1,4
open,6,3,4,4,4,21
lamour,3,3,0,3,4,13
city,12,6,5,8,8,39
boulevard,0,1,0,1,0,2
bite,2,0,1,2,3,8
guadalupe,1,0,0,0,1,2
realization,1,1,0,1,0,3
streetlight,1,0,0,0,0,1
boppin,1,1,0,0,0,2
southbound,1,1,0,1,1,4
boyfriend,2,0,2,1,1,6
douleur,1,0,0,0,1,2
folly,2,0,0,2,1,5
future,5,0,4,6,3,18
gravedom,1,0,0,1,0,2
sophie,1,1,1,0,1,4
nicer,0,0,0,0,1,1
turned,1,0,1,0,1,3
argument,0,1,0,1,1,3
alley,2,1,0,0,0,3
tastes,1,0,1,1,0,3
contara,1,1,0,0,1,3
horsepower,1,0,0,0,1,2
erinnerung,1,0,1,1,1,4
azucenas,0,1,0,0,0,1
mahafinaritra,1,1,0,1,1,4
wink,1,1,1,1,1,5
warriors,2,0,0,0,1,3
somethings,1,0,0,0,1,2
fertig,0,0,0,1,0,1
note,1,1,0,1,1,4
perdre,2,0,1,1,1,5
nota,1,1,0,0,0,2
take,40,21,16,20,26,123
destroy,4,1,3,2,2,12
blinding,1,0,0,0,0,1
butterfly,1,1,0,0,1,3
buffer,0,1,0,1,1,3
knew,1,0,0,0,3,4
knee,0,0,0,0,2,2
slonie,1,0,1,1,1,4
drive,7,2,3,3,4,19
badd,1,0,1,1,1,4
reinert,1,1,0,1,0,3
dolor,0,1,0,0,1,2
eeshwar,0,1,0,1,0,2
salt,0,0,0,1,0,1
stimulator,0,0,0,1,1,2
olha,0,1,0,0,1,2
saintetrinit,0,1,0,1,0,2
sinclar,1,0,0,0,1,2
peaches,1,1,1,1,1,5
boyz,0,0,0,1,0,1
bright,0,0,0,1,0,1
bitesize,1,1,1,1,1,5
slow,6,4,3,5,3,21
unkind,1,1,1,1,1,5
kalander,0,0,0,0,1,1
cloak,0,0,0,1,0,1
tears,6,5,2,3,7,23
going,17,13,8,10,16,64
actin,1,0,0,0,1,2
cerilene,1,0,1,1,1,4
nikolicaca,0,0,0,0,1,1
robe,1,0,1,1,1,4
caroline,2,1,0,1,2,6
remastered,33,12,15,16,26,102
beatles,0,0,0,0,1,1
wailin,1,1,0,1,1,4
siempre,2,1,0,0,1,4
monde,2,1,1,1,0,5
mondo,1,1,0,1,1,4
prime,0,1,0,0,1,2
phantasmagoria,1,0,1,1,0,3
bomba,2,2,0,2,0,6
pimp,0,0,0,1,0,1
artist,2,0,0,0,2,4
primo,0,0,0,0,1,1
parasitic,1,1,0,1,0,3
borrow,1,0,1,0,1,3
worried,1,1,0,0,1,3
diddy,1,0,0,0,1,2
roger,2,2,2,2,2,10
carolans,1,1,0,0,1,3
bombs,1,0,1,0,1,3
hotness,1,1,1,1,1,5
where,28,13,16,18,24,99
vision,2,0,1,0,1,4
espoirs,1,1,0,0,1,3
isabel,1,0,1,1,1,4
gangster,2,1,2,2,2,9
corre,0,0,2,0,2,4
juazeiro,1,1,0,1,0,3
ojitos,0,1,0,0,1,2
jumped,3,3,0,1,1,8
bootleg,0,1,0,0,0,1
lonley,1,0,0,1,1,3
teeny,1,0,0,1,1,3
clavo,1,1,0,1,1,4
sable,1,1,1,1,1,5
etouffe,0,1,0,0,1,2
jobs,1,0,1,1,0,3
lettin,1,0,0,0,0,1
caah,0,0,0,0,1,1
apparition,1,0,0,0,0,1
screen,2,1,2,2,1,8
concentrate,1,1,1,0,1,4
spare,2,1,1,1,1,6
persiana,1,0,0,0,1,2
spark,1,1,0,1,1,4
openbare,1,1,0,1,1,4
gnrique,1,0,0,1,1,3
mans,3,2,2,1,2,10
kardiogramm,1,0,0,1,1,3
many,5,3,0,0,3,11
jokers,0,1,0,0,0,1
dissidents,1,1,1,1,1,5
mana,0,0,0,1,0,1
manh,2,3,0,1,1,7
expression,0,1,0,0,0,1
mann,2,1,1,2,1,7
recordemos,0,0,0,0,1,1
olingi,0,1,0,0,0,1
stereophonic,0,2,0,2,2,6
anti,0,0,0,1,1,2
electrique,1,0,1,1,1,4
boar,0,1,0,0,0,1
mousetrap,1,1,0,0,1,3
boat,1,0,1,1,1,4
erden,1,0,0,1,0,2
collides,1,0,0,1,1,3
carino,1,1,0,1,1,4
west,5,5,2,3,5,20
vacation,2,0,1,1,2,6
concede,1,0,1,1,1,4
breath,4,0,0,2,3,9
earnshaws,0,0,0,1,0,1
influence,1,1,0,0,0,2
thousand,2,0,0,0,2,4
singalong,1,0,1,0,0,2
chao,0,0,0,0,2,2
vodne,1,1,1,0,1,4
runnin,2,1,1,1,2,7
polly,1,0,1,0,0,2
zearocks,0,0,0,0,1,1
tribal,0,0,0,1,0,1
whatevers,1,0,0,0,1,2
blackhawk,1,1,0,0,1,3
spotlight,1,0,1,0,1,3
binaural,0,3,0,3,3,9
aktensilvestereinlagendein,0,0,0,0,1,1
canon,1,0,1,1,0,3
dubious,1,1,1,1,1,5
twista,0,0,1,0,0,1
nation,2,0,1,1,2,6
desejo,0,1,0,0,0,1
binary,0,0,1,0,0,1
inoculated,1,0,0,0,0,1
fatima,1,1,0,0,1,3
coconuts,1,1,0,1,1,4
breakdown,3,1,2,2,3,11
laula,1,0,0,1,1,3
sickness,1,0,0,0,0,1
bside,1,1,1,1,1,5
halfblood,0,0,0,2,0,2
hummingbird,2,1,1,2,1,7
costa,1,0,0,1,1,3
colorblind,1,0,1,1,0,3
vacant,0,0,0,0,1,1
nothin,4,1,0,2,0,7
genio,1,1,0,1,1,4
dimension,2,0,1,1,2,6
summer,16,6,5,9,11,47
whitfield,1,0,1,1,0,3
being,3,0,3,0,0,6
hades,1,0,1,0,0,2
galopera,1,1,0,0,0,2
inaudible,1,0,0,0,1,2
darien,1,1,0,1,1,4
rover,1,1,0,1,1,4
distancia,0,0,0,0,1,1
bricks,1,0,0,0,0,1
skies,4,0,2,3,4,13
zion,3,2,0,3,2,10
around,24,14,9,17,22,86
shakuhachi,0,1,0,1,0,2
abagui,0,0,1,0,0,1
sodding,1,0,0,1,1,3
dark,10,8,3,7,6,34
traffic,2,0,2,1,1,6
world,46,37,18,38,37,176
dare,0,0,0,1,1,2
stranger,8,3,2,4,2,19
enero,0,0,0,1,1,2
wordless,1,0,0,1,0,2
souvenirs,1,0,2,1,2,6
gimme,3,0,1,1,1,6
enerv,1,1,0,0,1,3
clay,0,1,0,1,0,2
sellotape,0,0,0,1,1,2
inter,0,0,0,0,1,1
clap,1,1,0,1,1,4
junco,1,1,0,1,0,3
pickled,1,1,0,1,0,3
percussio,0,1,0,1,1,3
leng,0,0,0,0,2,2
divine,0,1,0,1,1,3
yesss,0,0,1,1,1,3
revenger,1,0,0,0,1,2
memories,0,0,0,1,0,1
tube,0,0,0,1,0,1
lend,1,0,0,1,1,3
ouro,0,1,0,0,0,1
ritmo,1,0,0,0,1,2
exit,0,0,0,0,1,1
juggernaut,1,0,1,1,0,3
power,4,3,1,5,3,16
sprung,1,0,1,1,1,4
lametavolante,0,0,0,1,1,2
jugglin,0,0,0,1,0,1
travelin,1,1,0,0,1,3
stone,4,1,3,2,3,13
esquilo,1,1,1,0,0,3
volumatic,1,0,1,1,1,4
neighbor,2,0,0,0,0,2
bond,1,1,1,1,0,4
berger,0,0,0,1,0,1
chivalry,1,1,1,1,1,5
burning,4,0,2,1,2,9
reconnu,0,1,0,0,0,1
antidote,1,0,0,0,1,2
hypnotise,1,0,0,1,1,3
charly,1,0,1,1,1,4
cerpin,1,0,1,1,0,3
apologize,0,0,0,1,0,1
mariage,1,1,0,1,1,4
rosso,0,0,0,1,0,1
faheem,0,1,0,1,0,2
braes,1,0,0,0,0,1
tropical,0,1,0,0,0,1
reinvigorated,1,0,0,1,0,2
aguas,1,1,0,1,0,3
cerises,0,1,0,1,1,3
mindless,1,0,0,2,1,4
worshippers,0,0,0,1,0,1
rudeboy,2,1,1,1,1,6
abandonada,0,1,0,0,0,1
bubble,2,1,0,1,2,6
goodman,0,0,0,0,1,1
lang,1,1,1,1,1,5
complete,3,2,1,0,2,8
limelighters,0,1,0,1,1,3
rainin,1,0,0,1,1,3
beginners,0,1,0,0,1,2
mich,6,3,2,5,6,22
with,65,39,17,41,59,221
mica,1,0,0,1,1,3
abused,1,0,1,0,0,2
pull,3,1,0,2,3,9
rush,1,0,1,0,1,3
raga,1,1,0,1,1,4
vanit,1,0,0,0,1,2
monopoly,1,1,1,1,0,4
monopatia,0,0,0,0,1,1
rago,1,1,1,1,1,5
ruse,1,0,1,0,0,2
dirty,8,4,3,5,7,27
jackhammer,1,0,0,1,1,3
darker,1,0,0,0,0,1
munda,1,0,0,1,1,3
gone,14,12,9,9,14,58
johnny,6,3,2,2,6,19
dnde,0,1,0,0,0,1
wartime,0,1,0,0,0,1
keinu,1,0,1,0,1,3
walked,0,0,0,0,1,1
frederali,0,1,1,0,0,2
watched,0,1,0,0,1,2
sawyer,1,0,0,0,1,2
cream,4,2,0,1,2,9
yoga,0,0,0,1,0,1
monsieur,0,1,0,0,1,2
muneca,0,1,0,1,0,2
tight,2,1,1,1,1,6
montanara,1,1,1,1,1,5
terre,1,0,1,1,1,4
annes,1,0,1,1,1,4
terra,0,0,0,1,0,1
averys,0,1,0,0,1,2
velvet,0,0,0,0,1,1
apartamento,0,0,0,0,1,1
mase,1,1,1,0,1,4
meditacao,1,1,0,0,0,2
clowning,1,1,0,0,0,2
hello,9,4,2,3,8,26
scudi,1,0,0,1,1,3
mass,1,0,1,2,3,7
nelson,1,1,0,1,1,4
acido,1,0,1,0,1,3
original,34,25,13,31,30,133
mauna,1,1,0,1,1,4
turbocharger,1,0,1,1,0,3
siyabonga,1,0,0,1,0,2
mason,2,2,0,0,2,6
verstehst,1,1,1,1,1,5
rapaz,0,1,0,1,0,2
hunting,1,1,0,1,1,4
tail,2,1,2,1,2,8
unreleasedrerecorded,1,0,0,0,0,1
tristeza,1,1,1,0,1,4
smile,7,7,4,5,9,32
crehans,1,1,0,0,0,2
feria,1,2,0,1,2,6
dulcimers,0,1,0,1,0,2
swallows,0,0,0,1,0,1
bator,1,1,1,1,1,5
floater,0,0,0,1,0,1
sans,1,2,1,2,1,7
cable,1,0,0,1,1,3
merrygorunaround,1,1,0,0,0,2
laying,0,0,0,1,1,2
dinosaur,2,1,2,2,2,9
sand,4,2,1,6,4,17
harry,2,2,3,4,3,14
small,4,3,2,2,4,15
largo,0,0,1,1,0,2
herzen,0,0,0,0,1,1
pasa,1,0,0,0,1,2
paso,0,0,0,0,1,1
healed,1,1,0,1,1,4
past,1,0,0,1,0,2
cheatin,1,1,0,1,1,4
pass,5,4,1,3,5,18
healer,2,0,0,1,1,4
gitana,1,1,0,1,2,5
poisonous,1,1,0,1,0,3
fleur,0,1,0,1,0,2
inolvidable,0,1,0,0,0,1
pecado,1,0,0,0,1,2
full,7,4,5,4,5,25
hours,3,0,2,2,3,10
tiis,1,1,1,1,1,5
palin,2,0,2,2,0,6
november,1,1,1,1,1,5
legend,1,1,1,0,2,5
pachelbel,1,0,1,0,0,2
melancholia,1,0,1,0,1,3
vlada,0,1,0,0,0,1
brutal,1,1,0,1,1,4
restcure,1,0,1,0,1,3
pick,0,0,0,0,1,1
raza,1,1,0,1,1,4
luck,6,4,3,2,5,20
dubbaq,0,0,0,1,0,1
slammin,1,0,0,0,1,2
silva,1,1,1,1,1,5
medianoche,1,1,0,0,1,3
pears,0,0,1,1,0,2
pokrusa,1,0,0,0,1,2
gorgeous,1,0,1,1,1,4
ballad,3,1,1,1,3,9
more,37,23,14,27,30,131
teen,0,0,0,1,1,2
door,6,2,3,5,7,23
kassoule,1,1,0,0,1,3
company,1,0,1,0,1,3
recordame,0,1,0,1,0,2
hotta,1,1,1,1,1,5
tntriko,0,0,0,0,1,1
doom,1,0,0,0,0,1
gravel,0,1,0,0,0,1
damien,1,0,0,0,1,2
science,1,1,1,1,1,5
malo,1,0,0,0,1,2
morgan,0,0,0,0,1,1
learn,1,2,0,2,0,5
knocked,2,1,1,1,2,7
seagull,1,0,1,1,1,4
zurezko,0,0,0,0,1,1
watcha,1,0,0,1,1,3
mala,0,0,0,1,1,2
beautiful,9,6,5,5,9,34
wieder,2,0,2,2,2,8
siks,1,1,0,0,1,3
ponte,1,1,1,1,1,5
rodriguez,1,1,0,0,1,3
neglected,1,0,1,0,1,3
ponto,0,0,0,1,1,2
accept,2,1,0,0,1,4
allegro,4,2,0,5,6,17
autumn,4,4,2,4,3,17
ponts,1,1,0,0,1,3
auer,1,0,0,1,1,3
sense,1,0,0,1,1,3
laukimas,1,0,0,0,0,1
mehr,2,0,1,1,1,5
scat,1,0,0,1,1,3
disconsolate,0,0,1,0,0,1
lejos,1,1,0,1,1,4
jhala,1,1,0,1,1,4
cline,1,1,0,1,1,4
creature,1,1,0,0,0,2
meraviglioso,1,1,0,1,1,4
armageddons,1,0,0,1,0,2
loefahs,1,0,0,1,1,3
brett,1,1,0,0,1,3
soundtrack,1,0,1,0,1,3
plane,1,0,1,1,1,4
scientas,1,0,1,1,1,4
saimera,0,0,0,1,0,1
leroy,1,0,0,1,1,3
rosebud,1,1,0,1,0,3
deuces,1,1,0,1,1,4
ogdens,1,0,1,0,1,3
putting,1,0,0,0,1,2
townson,1,1,0,1,0,3
mexican,0,1,0,0,1,2
letem,1,0,1,1,1,4
papel,1,0,0,0,1,2
trade,1,0,0,0,1,2
bksi,1,1,0,1,0,3
attitude,1,1,0,0,1,3
paper,7,4,3,2,4,20
scott,0,1,0,1,0,2
brin,1,1,0,0,1,3
signs,1,0,1,3,1,6
bulldozers,1,0,1,0,1,3
broadway,2,1,0,0,0,3
smiling,1,1,0,1,1,4
sahti,1,0,0,0,0,1
fonsi,0,0,0,0,1,1
alla,2,2,2,3,2,11
poetic,1,0,0,0,0,1
alli,0,0,0,0,1,1
superfly,1,0,0,0,0,1
tiempos,1,0,1,0,0,2
digas,1,0,1,0,1,3
tflische,0,0,0,0,1,1
sucker,1,0,0,0,1,2
personne,1,1,1,0,1,4
zhen,0,0,0,0,1,1
snowball,1,1,1,1,1,5
olivia,1,1,0,1,1,4
weeds,0,1,0,1,0,2
galope,0,1,0,0,1,2
dede,0,0,0,0,1,1
everytime,1,0,1,1,1,4
always,3,2,1,3,6,15
warung,0,0,0,2,0,2
found,5,2,3,2,4,16
vilking,1,1,0,1,1,4
upstairs,2,1,0,2,1,6
nossa,0,1,0,0,0,1
mackenzie,0,1,0,1,0,2
tonite,1,0,1,1,2,5
blues,78,79,25,29,41,252
really,3,4,1,4,4,16
suon,1,0,0,0,1,2
garvey,0,0,0,0,1,1
diskola,0,0,0,0,1,1
grottans,1,0,0,1,1,3
mikawa,0,1,1,1,1,4
darling,2,0,1,1,3,7
highway,2,2,0,0,2,6
guayabera,0,1,0,0,1,2
risen,2,0,1,0,0,3
drifting,2,2,0,2,2,8
weeg,1,0,0,0,0,1
porcelain,1,1,0,1,0,3
sparked,1,1,1,1,1,5
garons,1,0,0,1,1,3
entonces,1,0,0,0,1,2
imagino,1,0,0,0,1,2
weez,1,1,0,1,0,3
patitu,1,0,0,1,1,3
sensations,0,0,0,1,0,1
bumper,1,0,0,0,0,1
castle,4,3,1,3,3,14
major,4,1,1,2,3,11
guan,0,0,0,0,1,1
murallas,0,0,0,0,1,1
number,1,0,1,1,0,3
slipper,1,0,0,1,1,3
wees,1,1,0,0,0,2
ethereal,1,0,0,0,1,2
glitter,1,1,0,1,1,4
guess,0,1,0,0,1,2
heads,1,2,0,1,1,5
guest,1,0,1,1,1,4
introduction,3,2,1,1,2,9
avec,1,0,0,1,1,3
felicidades,1,1,0,1,0,3
saint,1,0,0,1,0,2
cunoasterea,1,0,0,1,0,2
unutmam,0,0,0,1,0,1
divertido,0,1,0,0,0,1
relationship,0,1,0,1,0,2
tbone,1,1,0,1,1,4
ernestine,1,1,1,1,1,5
stairs,2,0,1,2,2,7
grace,5,3,0,2,4,14
chahida,0,0,0,1,0,1
rappin,0,2,0,0,0,2
ablaze,1,0,0,0,0,1
desaster,1,1,0,1,0,3
getaway,1,1,0,1,0,3
vocal,5,1,2,3,4,15
freud,0,0,0,0,1,1
blons,0,1,0,0,0,1
cleos,1,1,0,1,1,4
suffocating,1,0,0,0,0,1
bavarian,0,1,0,1,0,2
antarctica,2,0,0,1,2,5
blond,0,1,0,0,1,2
suavecito,0,1,0,0,1,2
carlo,1,0,0,0,1,2
self,1,0,0,1,1,3
frail,1,0,1,1,1,4
play,7,6,2,3,5,23
brooklyn,1,0,0,0,1,2
plan,4,2,1,7,8,22
darts,1,0,1,1,0,3
buried,2,0,0,0,2,4
arson,1,0,0,0,1,2
seize,1,0,0,2,1,4
sometimes,5,1,3,2,3,14
cover,4,0,0,3,2,9
raag,1,1,1,1,1,5
coven,1,0,1,0,0,2
mompfreedonium,0,0,0,0,1,1
wishy,1,1,0,0,0,2
galicia,1,0,0,2,1,4
croix,1,0,0,0,1,2
gold,6,3,3,5,4,21
quiereme,0,1,0,0,1,2
toujours,2,0,2,2,2,8
fiann,0,1,0,0,0,1
session,3,3,1,1,3,11
freight,1,1,0,0,0,2
rebeneb,1,0,0,1,0,2
occupation,1,1,1,1,1,5
vltozott,1,0,1,1,1,4
sayin,0,0,0,1,0,1
writes,1,1,1,1,0,4
writer,1,0,1,1,0,3
failed,1,0,1,1,1,4
gracieusette,0,1,0,0,1,2
cassette,1,1,1,1,1,5
symptom,1,1,0,0,1,3
factor,1,0,0,0,0,1
turnaround,1,0,0,0,0,1
zephyrus,1,0,0,1,1,3
giants,1,1,0,1,0,3
downpour,1,0,1,0,1,3
toby,1,1,0,3,1,6
sunny,2,1,0,2,2,7
vuelves,0,0,0,1,1,2
remedy,0,1,0,0,1,2
banner,1,1,0,0,2,4
progressive,1,0,0,0,1,2
ahmea,1,0,0,1,1,3
roughest,1,0,0,0,0,1
belles,1,0,1,1,1,4
croatia,2,0,0,0,0,2
scelxenak,1,1,0,1,0,3
manger,2,1,0,2,2,7
anglois,1,1,1,0,1,4
noize,1,0,1,1,1,4
aberdeen,1,1,0,0,0,2
outward,0,1,0,1,1,3
knees,3,2,0,2,3,10
movin,1,0,1,1,1,4
ritz,1,0,1,0,1,3
movie,0,0,0,2,1,3
demons,1,0,1,0,0,2
lihava,1,0,0,0,0,1
vitamina,0,1,0,0,0,1
rite,0,1,0,0,0,1
monsters,2,1,2,2,1,8
rita,0,1,0,1,0,2
europe,2,0,2,1,1,6
losangeles,1,1,1,0,0,3
temblando,0,0,0,0,1,1
adagio,4,2,1,1,3,11
prospects,5,0,5,5,0,15
lass,0,1,0,0,0,1
last,27,10,15,15,21,88
thou,1,1,0,1,1,4
raineys,1,1,0,0,0,2
troppo,2,1,0,1,2,6
cuerda,0,0,0,0,1,1
radames,1,0,0,1,0,2
colpa,0,0,0,1,1,2
whole,1,0,0,0,0,1
patty,1,1,1,1,1,5
majesty,3,2,0,2,1,8
bell,1,0,0,1,1,3
etre,1,0,1,1,2,5
seems,1,2,1,1,1,6
hollow,1,0,1,2,1,5
leos,1,1,1,1,1,5
eoarchaean,1,0,0,0,0,1
church,3,2,1,2,2,10
pensamiento,1,0,0,0,1,2
belt,1,0,0,1,1,3
devin,1,1,0,1,0,3
devil,8,7,0,5,4,24
prefiero,0,0,0,0,1,1
blink,1,0,0,0,1,2
geoffrey,1,1,0,0,1,3
meseta,1,0,1,1,1,4
firm,1,0,0,0,1,2
mcnamarad,1,0,0,1,1,3
champion,0,0,0,1,0,1
fire,25,10,4,11,14,64
boweavil,1,1,0,0,0,2
gertens,1,0,1,1,1,4
races,2,0,0,2,2,6
awake,2,0,4,3,0,9
chester,0,1,0,0,1,2
funk,4,2,2,5,3,16
mujeres,1,1,0,0,0,2
straight,2,0,0,1,0,3
error,0,0,0,1,0,1
kissing,1,0,0,1,1,3
robin,1,1,0,0,1,3
swim,0,0,0,1,0,1
pound,1,1,1,1,0,4
hoping,1,1,1,1,1,5
moth,1,1,0,1,0,3
calculator,1,0,0,1,1,3
owen,1,1,0,1,1,4
gangstas,0,0,0,1,1,2
xiao,0,0,0,0,2,2
ducks,1,0,0,1,0,2
macarena,0,0,0,0,2,2
trapze,0,0,0,0,1,1
cliftons,1,1,0,0,0,2
chase,2,0,2,2,2,8
funny,1,2,0,0,2,5
adios,3,1,1,1,5,11
objekt,0,0,0,1,0,1
starlight,1,0,0,0,0,1
acabo,0,1,0,0,0,1
politrix,0,0,0,0,1,1
knigin,1,0,0,1,1,3
read,1,1,0,0,1,3
ryegrass,0,0,0,1,0,1
forgiveness,2,1,1,0,2,6
dooley,1,0,0,0,0,1
inferno,1,0,0,1,0,2
eure,1,0,1,0,1,3
codazos,0,1,0,1,0,2
illoin,1,0,0,1,1,3
giorno,1,0,1,1,1,4
fabrication,1,0,1,1,1,4
assabah,0,0,1,1,1,3
makes,2,0,0,0,1,3
conversar,0,0,0,0,1,1
person,1,0,0,0,1,2
leone,0,1,0,0,0,1
rudolph,1,2,0,2,2,7
salva,0,0,0,1,1,2
tanguero,1,1,0,0,1,3
andorra,1,1,0,1,1,4
eager,1,1,0,1,0,3
sydney,2,1,2,1,2,8
romanza,0,1,0,1,0,2
remast,0,0,0,0,1,1
australia,0,0,0,1,1,2
victims,2,1,2,2,1,8
emergency,4,0,1,0,4,9
wives,2,2,1,2,2,9
heilige,1,0,0,1,1,3
shitty,1,0,0,0,0,1
suffering,1,0,0,1,1,3
quest,2,1,1,1,0,5
hitters,1,1,0,1,0,3
kennedy,1,0,0,0,1,2
ivan,0,1,0,0,0,1
disorder,1,0,0,1,1,3
squanderer,1,1,1,1,1,5
goddamn,1,1,1,0,1,4
augmentent,1,0,0,1,1,3
unloved,1,0,1,0,0,2
bounce,1,3,0,4,1,9
palm,2,2,1,0,0,5
greener,1,1,0,1,1,4
curious,1,1,0,1,1,4
wesson,1,1,1,0,0,3
pale,2,1,0,2,2,7
irresistible,1,0,0,1,1,3
gullveig,1,0,0,0,0,1
intocable,1,0,0,0,1,2
sentimentos,1,1,0,1,1,4
monaxias,0,0,0,0,1,1
temple,1,0,0,1,0,2
hypergasm,1,0,1,1,0,3
requiem,2,1,2,1,2,8
kreuzpolka,1,1,0,1,0,3
nowhere,2,1,2,1,2,8
santa,3,4,0,2,3,12
carol,3,2,2,2,3,12
chola,0,1,0,0,0,1
pietra,1,0,0,1,0,2
chatterbox,0,0,0,0,1,1
veces,1,1,1,0,1,4
anything,3,1,2,3,4,13
liberi,1,0,1,0,1,3
melbourne,0,0,0,1,0,1
ambush,1,0,1,1,0,3
almendra,0,1,0,0,0,1
kassie,1,0,1,0,0,2
terapia,1,0,0,0,1,2
into,15,3,8,10,13,49
inti,0,1,0,0,0,1
beira,0,1,0,0,1,2
contestadora,1,1,1,1,1,5
volcan,1,1,0,1,1,4
katie,1,0,0,1,1,3
soca,0,1,0,0,1,2
spending,0,0,0,1,1,2
degero,1,1,1,1,0,4
stenhouse,1,0,0,0,0,1
submit,1,0,1,1,0,3
suis,1,1,1,1,2,6
suit,1,0,1,1,1,4
blueprint,1,1,1,1,1,5
atlantis,1,2,1,0,2,6
jacks,1,0,1,1,1,4
hawaiian,0,1,0,1,1,3
ailleurs,2,0,0,0,0,2
atlantic,0,0,0,1,1,2
atom,0,0,1,0,0,1
ling,0,0,0,0,1,1
coldest,1,1,0,1,1,4
line,6,3,2,3,4,18
fades,1,1,0,1,2,5
grandmre,1,1,0,0,1,3
erick,1,1,1,1,1,5
erica,2,2,1,1,2,8
redeemer,1,0,1,1,1,4
mandown,1,0,0,1,1,3
marseille,1,1,1,1,1,5
consumed,1,0,0,1,0,2
supervisor,1,1,1,1,0,4
schnes,0,0,0,1,1,2
oddity,1,1,1,1,1,5
unsafe,1,1,0,1,0,3
haunt,1,1,1,0,0,3
chat,1,0,0,1,1,3
aulis,1,0,0,1,1,3
phantom,1,0,0,0,1,2
thugs,1,1,0,1,2,5
tara,1,0,0,1,0,2
occasional,1,1,1,1,1,5
ascoltarti,1,0,0,1,0,2
sails,0,1,0,0,1,2
robots,2,1,0,2,1,6
shenandoah,1,0,0,1,1,3
xing,0,0,0,0,2,2
cnlathe,1,1,0,0,1,3
lane,2,2,0,0,1,5
land,3,0,2,3,4,12
lana,1,0,1,0,1,3
lann,1,0,1,1,1,4
dche,1,1,1,1,1,5
adnans,0,0,0,1,0,1
walker,1,1,0,0,1,3
fresh,0,0,0,1,0,1
having,1,1,1,1,1,5
partial,0,1,0,0,0,1
dawning,1,0,0,1,0,2
scratch,1,1,1,1,1,5
laziness,0,0,0,1,0,1
existing,1,0,1,1,0,3
brightside,1,0,1,0,1,3
chillin,1,1,1,1,1,5
cody,1,0,1,0,0,2
seni,0,0,0,0,1,1
popularesasa,1,1,0,1,0,3
young,10,8,7,4,10,39
send,3,1,2,1,1,8
contours,1,1,0,1,1,4
sens,2,1,0,2,2,7
dancehall,1,1,0,1,0,3
sent,1,1,1,1,1,5
garden,3,3,3,3,3,15
tulsa,2,0,2,2,2,8
kuriye,0,0,0,1,0,1
llama,1,1,1,1,0,4
magic,2,1,0,2,1,6
transmission,2,0,0,1,1,4
gettin,3,2,2,3,3,13
anakonda,1,0,1,1,0,3
race,1,1,0,1,1,4
reich,1,0,0,1,1,3
severed,1,0,0,1,0,2
morpha,0,0,1,0,1,2
cuantas,0,0,0,1,1,2
everythings,2,1,0,1,2,6
tora,0,0,1,0,1,2
video,2,2,1,3,2,10
enclosed,1,0,0,0,1,2
index,1,1,0,0,1,3
apparatus,0,0,1,0,0,1
morse,0,0,0,0,1,1
anton,1,0,0,1,0,2
sweaty,1,0,0,0,0,1
indian,3,1,1,3,3,11
twins,1,1,0,1,0,3
bird,3,2,0,2,4,11
balle,0,0,0,0,2,2
seine,1,1,0,1,0,3
jammaster,1,1,1,1,1,5
guama,0,1,0,0,0,1
laddie,0,1,0,0,0,1
terve,1,1,1,1,1,5
fifteen,1,1,0,0,0,2
loser,1,0,0,0,1,2
great,5,4,2,3,5,19
shuffling,1,0,0,0,0,1
derby,1,0,0,1,1,3
popcorn,1,0,1,1,1,4
abupia,1,1,0,1,1,4
stephanie,1,1,1,1,1,5
dsol,1,0,1,1,1,4
thats,6,3,4,2,4,19
manies,1,1,1,1,1,5
tipico,0,1,0,0,1,2
fractured,1,0,1,1,0,3
kokoro,0,2,0,2,2,6
loca,1,0,0,0,1,2
bust,1,0,0,0,1,2
palabra,0,1,0,1,0,2
menino,0,1,0,0,0,1
standing,5,5,1,2,2,15
confidence,0,1,0,0,0,1
theme,13,5,1,12,14,45
next,8,3,4,3,5,23
roda,0,1,0,0,1,2
doubt,1,0,1,0,0,2
paune,0,0,0,1,1,2
baba,1,0,0,0,1,2
babe,1,0,0,0,0,1
kolomeyke,1,0,0,1,1,3
zalozniy,1,0,0,1,0,2
carrying,1,0,0,1,1,3
losin,1,1,1,1,1,5
baby,53,33,13,20,31,150
bihoue,1,0,1,1,1,4
balls,1,1,0,0,1,3
this,62,28,28,37,52,207
ballz,0,0,0,1,0,1
pour,5,0,3,3,3,14
badan,0,0,0,1,1,2
emerson,0,0,0,2,0,2
thin,3,0,2,1,2,8
ballo,2,0,0,1,1,4
melilla,1,0,0,1,0,2
process,1,2,1,3,3,10
lock,2,2,0,2,1,7
loco,1,2,0,3,3,9
pieces,1,0,0,0,0,1
high,14,8,6,8,11,47
spruce,1,0,0,1,0,2
slip,2,0,1,1,1,5
beni,0,1,0,0,1,2
flamenco,0,1,0,0,0,1
trumpet,1,2,0,1,0,4
martyr,1,0,1,0,1,3
mujer,1,0,1,0,1,3
animal,1,0,1,0,0,2
dificiles,1,0,1,0,0,2
comedy,1,0,0,0,0,1
cristal,1,1,1,2,1,6
tien,1,1,1,0,0,3
javalon,1,1,0,1,0,3
gardner,0,1,0,0,0,1
strumentale,0,0,1,1,0,2
hawa,1,0,0,1,1,3
tarantella,0,1,0,0,0,1
robot,1,0,0,1,1,3
zabel,0,1,0,1,0,2
espaol,1,1,0,1,1,4
realizer,1,0,0,1,1,3
noches,1,1,0,0,0,2
counted,1,0,1,1,1,4
houston,0,0,0,1,1,2
standin,2,2,1,1,1,7
kiinni,1,0,0,0,0,1
brahms,1,0,1,0,0,2
bitty,1,0,0,1,1,3
directo,7,0,4,1,7,19
move,8,4,4,4,5,25
produced,2,0,0,2,0,4
ragoo,1,0,1,0,1,3
motorcycle,1,1,1,1,1,5
volta,0,1,0,0,1,2
warren,0,0,0,1,0,1
perfect,5,1,2,2,3,13
inishmore,0,0,0,0,1,1
mediterrani,1,0,0,0,1,2
punchdrunk,1,1,1,1,1,5
thieves,0,1,0,0,0,1
degrees,1,0,1,1,0,3
milkcow,2,2,1,0,2,7
communication,1,0,0,3,0,4
jody,3,2,0,0,1,6
brockington,1,1,0,1,1,4
recept,0,0,0,1,0,1
morgen,0,1,0,1,0,2
nada,1,4,1,2,3,11
mediocre,1,1,1,0,1,4
federico,0,1,0,0,1,2
rossen,1,0,0,0,1,2
kiss,7,4,2,5,6,24
cocotaso,0,1,0,1,0,2
doce,0,1,0,1,0,2
cursed,2,0,1,0,1,4
scenic,1,0,1,1,0,3
vibrations,1,1,1,1,1,5
goodtime,0,0,0,0,1,1
betty,4,2,2,4,3,15
truth,4,2,3,4,4,17
stewkey,1,0,1,0,1,3
beneath,2,2,3,1,3,11
traces,1,0,0,1,1,3
amoria,0,0,0,1,0,1
chickasay,1,0,0,1,0,2
shower,3,3,1,3,0,10
soixantequatre,0,1,0,1,0,2
doing,2,1,2,1,2,8
society,1,0,1,0,1,3
frequency,1,0,0,1,0,2
static,2,1,1,0,2,6
thirteen,0,0,1,0,1,2
jagged,1,0,0,0,1,2
witness,1,1,1,1,1,5
cesa,1,0,1,1,1,4
carita,1,0,1,1,1,4
cest,9,5,5,8,8,35
contigo,2,1,0,2,3,8
czar,1,1,0,0,0,2
shut,2,0,2,1,2,7
tempo,2,1,1,1,2,7
temps,0,1,0,1,1,3
shuo,0,0,0,0,2,2
shui,0,0,0,0,1,1
mesmerized,0,1,0,1,0,2
could,8,7,4,6,6,31
scars,1,1,1,0,1,4
david,2,1,0,3,3,9
blaue,1,0,1,1,0,3
anita,0,1,0,0,0,1
digitaria,1,1,1,1,0,4
piney,1,1,0,0,1,3
loverman,1,0,1,0,1,3
blown,1,1,1,1,1,5
scene,2,0,0,2,1,5
jesus,11,9,5,7,11,43
dendemnner,1,0,1,1,1,4
damit,1,0,0,1,1,3
baiao,1,1,0,1,0,3
affliction,1,0,1,1,1,4
owner,1,1,1,1,1,5
milagre,1,1,0,1,0,3
disaster,1,0,0,0,0,1
festival,2,1,1,2,2,8
traveller,2,2,1,2,2,9
system,2,0,1,3,1,7
ptit,1,2,0,0,2,5
sloignent,1,0,0,0,1,2
stomach,1,0,1,1,0,3
liang,0,0,0,0,2,2
chagrin,1,0,0,1,1,3
burlesque,1,0,0,0,0,1
karuna,1,1,0,1,1,4
thresh,1,0,0,0,1,2
tuscan,1,1,0,1,1,4
chong,0,0,0,0,1,1
groovitation,0,1,0,1,0,2
steel,2,2,0,0,2,6
marrakesh,0,0,0,1,0,1
bother,1,1,0,1,1,4
roberto,0,0,0,0,2,2
gaye,0,0,0,1,0,1
psalm,1,1,0,3,0,5
devotion,1,0,0,1,0,2
collecting,1,0,1,0,0,2
false,2,0,0,0,0,2
ipanema,1,1,0,0,1,3
kutt,1,1,0,1,1,4
lines,2,0,2,1,1,6
partnership,1,1,0,1,1,4
gently,1,0,1,0,1,3
tonight,14,4,5,7,17,47
gentle,1,1,0,1,2,5
zarkov,0,0,1,1,1,3
vaca,1,1,0,0,0,2
brokendown,1,1,0,0,0,2
heft,1,0,0,1,0,2
solls,1,1,1,1,1,5
dishes,2,1,1,1,2,7
lungenkrebs,1,0,0,0,0,1
maclean,1,0,1,1,1,4
hangover,1,0,1,1,1,4
cuatro,1,1,0,1,1,4
sinatra,0,1,0,0,1,2
latina,0,1,0,1,0,2
babes,1,0,1,1,1,4
lindo,0,1,0,0,2,3
linda,1,1,0,0,0,2
korean,1,0,0,1,0,2
sirius,1,1,0,2,0,4
milla,2,2,2,2,2,10
filosofia,1,1,0,0,1,3
brazil,0,0,0,1,0,1
flipside,1,0,0,1,1,3
nerio,1,1,1,1,1,5
device,1,0,1,1,1,4
loafin,1,1,0,0,1,3
perpetuo,1,1,0,1,1,4
viso,0,1,0,0,0,1
paladar,1,1,0,1,0,3
coutant,1,1,0,1,1,4
locust,2,0,1,0,2,5
face,7,6,3,5,9,30
donneznous,1,0,1,1,1,4
wounded,1,0,0,0,1,2
painting,1,1,0,1,1,4
fact,1,1,1,0,1,4
atmosphere,1,0,0,1,0,2
bring,5,2,3,2,3,15
manchester,1,0,0,1,1,3
noirs,0,1,0,1,0,2
rouge,1,3,0,1,1,6
rough,2,1,1,2,2,8
brink,1,0,0,0,1,2
noir,0,1,0,0,1,2
slamka,0,0,0,0,1,1
maputo,1,1,0,0,1,3
declouet,1,1,0,1,0,3
schwarzarbeit,1,1,1,1,1,5
tape,1,0,0,1,1,3
tudo,1,1,0,1,2,5
volts,0,1,0,0,1,2
mmix,0,0,0,1,0,1
bourbon,1,1,0,0,0,2
mikhails,0,1,0,1,0,2
meant,2,1,1,1,2,7
handle,2,1,0,2,2,7
abba,1,0,0,0,0,1
means,2,0,1,2,2,7
lucky,3,3,1,3,2,12
wiggle,1,1,1,0,0,3
livinin,1,1,0,0,1,3
anandi,1,1,0,1,1,4
smash,0,0,0,1,0,1
notas,0,1,0,0,0,1
keiner,1,0,0,1,1,3
reis,1,0,1,1,1,4
souljahz,1,0,1,1,1,4
locaccmaccam,0,1,0,0,1,2
lala,1,0,0,1,1,3
rjouissance,0,1,0,0,0,1
stuff,2,2,1,0,1,6
ganzes,0,0,0,0,1,1
basking,1,0,0,1,0,2
ohio,2,0,0,1,2,5
superstars,1,0,0,1,1,3
darbys,1,0,0,0,1,2
perdido,1,1,0,1,1,4
heartburn,1,1,0,0,1,3
edition,4,3,1,4,1,13
triomusic,1,0,1,1,0,3
packed,1,1,0,1,1,4
dungeon,1,0,0,1,1,3
wire,2,1,0,0,1,4
paseo,1,0,0,1,1,3
waltzing,0,1,0,0,2,3
sietmtn,1,0,1,1,1,4
mies,2,0,1,1,2,6
pistol,1,0,1,1,0,3
youll,7,6,3,6,7,29
email,0,0,0,1,1,2
keynote,1,1,0,1,0,3
bilal,1,1,0,1,1,4
courtyard,1,1,0,1,1,4
bolivian,1,0,1,1,1,4
ende,1,0,1,1,1,4
nieve,1,1,0,2,2,6
lotion,1,0,1,1,1,4
drum,8,1,3,6,8,26
dumbledore,0,0,0,1,0,1
drug,1,0,0,0,1,2
kofw,0,0,0,1,0,1
marta,0,1,0,0,1,2
sangen,1,0,0,0,0,1
viziers,1,1,0,1,1,4
lustrate,1,0,0,1,0,2
mmoire,1,0,1,1,1,4
whispering,3,2,1,3,3,12
labor,1,0,0,0,0,1
meantime,2,1,2,1,2,8
vuelvas,1,0,0,0,1,2
poured,1,0,0,1,0,2
baignoire,0,1,0,0,1,2
feather,2,0,0,0,2,4
waste,2,1,1,0,1,5
louisiana,1,1,0,0,1,3
trinity,1,0,0,1,0,2
choses,1,0,0,0,0,1
eduardo,1,1,0,0,0,2
salvaje,0,1,0,0,1,2
roasting,1,1,0,1,0,3
spain,1,0,1,0,1,3
laser,1,0,1,0,1,3
dsir,0,1,0,0,1,2
barquito,1,0,0,0,1,2
greco,1,0,0,1,1,3
sirne,0,1,0,0,1,2
bathtub,0,0,0,1,1,2
ombre,1,0,0,1,1,3
aliento,1,0,1,1,1,4
mimila,0,0,0,0,1,1
lust,2,2,0,2,1,7
wameru,1,1,0,1,1,4
tenor,0,1,0,0,0,1
ransom,1,0,1,1,1,4
tattoo,2,0,1,2,2,7
terrorist,0,0,0,1,0,1
juan,2,1,1,2,1,7
romance,3,2,1,2,2,10
matthew,2,2,1,1,2,8
paula,0,0,0,1,0,1
sada,0,0,0,1,0,1
ball,2,2,1,2,2,9
columbia,2,0,2,0,2,6
oriza,1,1,0,1,1,4
soeur,1,0,0,0,0,1
bald,1,1,0,1,0,3
upon,6,4,1,5,5,21
hasnt,1,0,0,0,0,1
dust,1,0,1,0,0,2
hartz,1,0,0,1,1,3
therapie,1,0,0,1,1,3
philippic,1,0,0,1,1,3
dstockage,1,1,1,1,1,5
shotgun,1,0,1,0,0,2
colour,1,0,1,1,0,3
sarapatel,0,1,0,1,0,2
patterns,1,0,0,1,1,3
audio,1,0,1,1,1,4
presbytre,1,1,0,1,1,4
albinoni,1,0,1,0,0,2
flesh,1,0,0,1,1,3
momento,1,2,1,0,1,5
shiloh,1,0,0,1,0,2
paul,4,2,1,2,4,13
unplugged,1,1,0,1,1,4
lesk,1,0,0,1,0,2
begin,0,0,0,0,1,1
danser,1,2,1,1,2,7
parfume,1,1,0,1,1,4
nacional,1,0,0,0,1,2
arrest,1,1,0,1,1,4
crack,1,1,1,1,1,5
villagers,1,1,1,1,1,5
parfums,0,1,0,1,0,2
cavasamba,0,1,0,1,1,3
complicity,1,0,1,1,1,4
cruz,1,1,0,1,1,4
cedar,0,1,0,1,0,2
dures,0,1,0,1,0,2
tomara,1,1,0,1,1,4
pienses,1,1,0,1,0,3
poikamies,1,0,0,0,0,1
nordmark,1,0,0,1,0,2
cosas,3,3,0,2,2,10
stagger,1,0,1,0,1,3
replacement,1,0,1,1,1,4
bleedin,1,0,1,0,0,2
immortal,1,0,0,0,1,2
daylight,1,0,1,1,1,4
springs,2,2,1,0,0,5
blonde,1,0,0,0,1,2
radioland,1,0,1,0,1,3
unsaveable,1,0,0,0,1,2
breakout,2,0,0,2,1,5
passion,4,4,2,5,4,19
forgiven,1,0,0,0,0,1
stairway,1,0,0,0,1,2
blowing,1,1,0,0,0,2
pressure,1,0,1,0,0,2
ingrato,1,0,0,0,1,2
imaginary,1,1,0,0,1,3
stage,1,1,0,0,1,3
iris,1,1,0,1,0,3
sister,3,1,2,1,2,9
lifestyle,1,0,1,0,1,3
angeles,1,1,1,1,1,5
hier,1,1,0,0,1,3
rockwilder,0,0,0,0,1,1
bescheid,0,0,0,1,0,1
burma,1,1,0,1,1,4
letters,2,1,1,1,2,7
pussy,0,0,0,1,0,1
irreversveis,1,0,0,0,0,1
pianolude,1,1,1,1,1,5
meri,1,0,1,0,1,3
luna,2,3,0,3,2,10
donde,1,1,0,0,1,3
lung,0,0,0,1,2,3
lune,1,1,1,2,2,7
roads,2,1,0,0,0,3
phylyps,1,1,1,1,0,4
mykel,1,0,1,0,1,3
muerto,0,1,0,1,0,2
moonmans,0,1,0,1,1,3
muerte,1,0,1,1,1,4
flynn,0,0,0,0,1,1
function,1,0,1,1,1,4
mathilda,1,0,0,1,1,3
fceelo,1,1,1,1,0,4
marquis,1,1,0,1,1,4
places,1,1,1,1,1,5
underland,0,0,0,1,0,1
smooth,1,1,0,0,1,3
chroniques,0,0,0,1,0,1
chela,0,1,0,0,0,1
mdium,1,0,1,1,1,4
problem,4,1,1,1,1,8
stepmothers,1,1,1,1,1,5
dornrschen,0,0,0,1,1,2
eskomolto,1,0,0,1,1,3
rubble,1,0,1,0,1,3
suan,1,1,0,1,1,4
calle,1,1,0,1,1,4
tsarvitch,0,1,0,0,0,1
seul,1,0,0,1,1,3
details,1,1,0,1,1,4
rosalita,1,1,0,0,1,3
maudits,1,1,1,0,1,4
illusion,1,1,0,1,0,3
reckless,1,1,0,1,0,3
repeat,1,0,1,0,0,2
monday,2,4,0,2,3,11
greasers,1,0,0,1,0,2
footprints,0,0,0,2,0,2
chance,4,3,3,4,5,19
quarto,1,0,0,1,0,2
epilogue,1,0,0,1,0,2
toribio,1,1,0,1,1,4
skincree,1,0,1,1,0,3
ghost,4,2,3,1,4,14
searcher,1,0,0,0,0,1
mozart,3,2,1,1,3,10
rule,1,0,1,0,0,2
strings,0,1,0,0,0,1
eddies,1,1,0,0,0,2
elaine,1,1,1,1,1,5
kickstart,1,1,0,0,0,2
suicidal,1,0,1,0,1,3
rebelion,1,0,0,0,1,2
gesehen,1,0,1,1,1,4
poaki,0,0,0,1,0,1
mansion,0,0,0,0,1,1
saved,2,2,1,2,2,9
drinkin,1,0,1,1,1,4
murmioon,0,0,0,1,1,2
orpheus,0,1,0,0,1,2
qubcois,1,0,0,1,1,3
sahnu,0,0,0,1,0,1
worth,0,0,0,0,1,1
gobbler,1,1,0,1,1,4
aurora,1,1,1,1,1,5
exception,1,0,1,0,0,2
washboard,1,1,0,0,0,2
trinkhalleluja,0,0,0,0,1,1
shitzzo,1,0,0,1,0,2
tickets,1,0,0,0,1,2
bewildered,1,0,0,0,1,2
alovi,0,1,0,0,0,1
monologue,0,0,0,1,0,1
gzlerinde,0,1,0,1,0,2
triumph,0,1,0,1,0,2
jamaica,2,1,0,0,1,4
guitares,2,2,0,1,2,7
horn,2,2,1,2,1,8
preacher,0,1,0,1,0,2
deportees,1,0,1,1,1,4
chen,0,0,0,0,1,1
koobatronmix,1,1,1,1,1,5
panda,1,0,0,1,1,3
poika,1,0,1,1,0,3
freezin,1,0,0,0,1,2
above,5,3,1,2,3,14
lizzie,1,0,0,0,1,2
told,1,1,0,0,0,2
aeroplane,1,1,0,0,1,3
guiter,0,1,0,0,1,2
pursuit,1,1,0,1,1,4
celebration,3,0,2,3,3,11
gossippo,1,1,0,1,1,4
tant,0,0,0,1,0,1
daughter,4,2,1,2,1,10
walkin,3,4,2,2,4,15
bhul,0,0,0,1,0,1
smoke,8,8,1,4,1,22
lonesome,4,4,1,1,5,15
spooks,1,1,1,1,1,5
kindhearted,1,1,0,0,0,2
instr,1,0,1,0,1,3
fiends,0,0,0,0,1,1
darlings,1,0,0,1,1,3
lhorizon,1,1,0,1,1,4
hindsight,0,0,1,0,0,1
total,3,1,2,1,3,10
haendel,0,0,0,0,1,1
sarah,3,0,3,2,1,9
plot,1,0,1,0,1,3
plamuk,0,0,0,0,1,1
alligator,2,2,1,1,1,7
neckbones,1,1,0,0,1,3
cutdown,1,0,1,0,0,2
indiana,1,0,0,0,1,2
blueberry,1,0,0,0,1,2
giovanni,1,1,1,1,1,5
reign,4,2,4,3,4,17
aware,1,0,0,0,0,1
escapist,1,0,0,0,1,2
cured,1,0,0,0,0,1
word,7,1,2,2,6,18
spielin,1,1,1,0,0,3
worm,1,0,1,1,1,4
breakfast,1,0,0,0,0,1
mortar,1,0,0,0,0,1
elbow,0,1,0,1,0,2
shrivasta,1,1,0,1,0,3
gloria,2,1,1,2,2,8
radiance,1,1,1,1,0,4
jest,1,0,0,1,0,2
india,1,1,0,0,0,2
heartless,1,0,0,0,0,1
violin,2,2,0,0,0,4
indifferent,1,0,0,0,1,2
sinnloz,1,0,1,1,0,3
nuts,1,0,0,1,0,2
playgirls,1,0,0,0,0,1
very,2,0,0,1,1,4
rewind,2,1,2,2,2,9
interview,2,1,1,0,1,5
nombre,0,0,0,0,1,1
ordinary,2,0,1,1,1,5
beach,1,0,1,3,1,6
gamble,1,0,0,1,1,3
pizza,1,1,1,1,1,5
fever,1,1,0,0,1,3
merritt,1,0,0,1,1,3
ladder,2,2,1,2,2,9
after,12,8,6,8,11,45
drones,1,0,0,0,1,2
bottles,1,1,0,1,1,4
rebao,0,1,0,1,1,3
arco,2,2,0,1,1,6
poursuivi,0,1,0,0,0,1
cosmonaut,1,0,0,0,1,2
hasta,1,1,0,1,2,5
greek,0,0,1,1,0,2
green,6,4,1,3,5,19
cannonball,2,1,0,0,1,4
ambulance,1,1,0,0,0,2
pdog,1,1,0,1,0,3
order,3,1,2,2,3,11
greed,2,0,2,2,1,7
office,0,0,0,1,0,1
rire,0,0,0,1,1,2
satisfied,1,1,0,1,1,4
ompa,1,1,1,1,1,5
bubbles,0,0,0,0,1,1
venti,1,0,0,1,1,3
somewhere,2,4,3,3,3,15
highlights,1,0,0,1,0,2
venta,0,1,0,0,0,1
vente,0,0,0,1,0,1
introwhatcha,1,1,1,1,1,5
fauch,1,0,0,0,0,1
harmony,4,3,2,3,4,16
versus,2,0,0,0,0,2
then,3,2,2,4,5,16
them,3,0,2,1,1,7
hons,1,1,0,0,1,3
bruttosozialprodukt,1,1,1,1,1,5
thee,2,0,0,0,3,5
safe,6,3,3,4,5,21
deinem,0,0,0,0,1,1
collide,1,1,1,0,1,4
break,12,6,7,11,13,49
band,3,2,3,4,5,17
bang,5,2,2,4,4,17
sentimental,2,2,0,1,2,7
shameful,1,0,0,0,1,2
they,10,4,6,5,8,33
czwarty,1,0,0,1,1,3
bread,2,1,0,0,1,4
gallows,1,0,0,0,1,2
pobre,1,0,0,0,1,2
rocks,3,1,1,1,3,9
volvere,0,0,0,0,1,1
carlow,1,1,0,0,0,2
carlos,1,1,0,1,1,4
lifted,1,0,0,1,1,3
crimes,1,0,1,0,0,2
sled,1,0,1,0,1,3
termiche,1,1,0,1,1,4
trybal,0,0,0,1,0,1
vesela,1,1,1,0,1,4
blows,2,1,1,1,2,7
viertel,1,0,0,1,1,3
strangers,1,0,0,0,1,2
daniel,2,1,1,0,2,6
remorse,1,1,0,1,0,3
medicine,1,0,1,0,0,2
vete,1,0,0,1,1,3
tian,1,0,0,0,5,6
techno,0,0,0,0,1,1
certified,0,0,0,1,0,1
regresa,1,0,0,0,1,2
footsteps,1,1,0,1,1,4
isola,1,1,0,1,1,4
chopped,0,0,0,0,3,3
another,14,5,8,11,13,51
comin,6,2,2,3,3,16
tangle,1,0,0,0,1,2
ballin,1,1,1,1,1,5
mojo,1,2,0,1,0,4
dogg,0,0,0,0,1,1
elevator,1,1,0,2,1,5
compromise,2,1,2,2,0,7
solamente,0,1,0,0,0,1
john,3,4,2,5,4,18
dogs,2,0,0,1,2,5
efface,1,0,0,0,1,2
yourn,0,0,0,0,1,1
innizar,1,0,1,0,0,2
teardrops,2,1,0,2,2,7
albert,2,2,0,2,2,8
booklovers,1,1,0,1,0,3
chanter,1,1,0,1,1,4
wasted,3,0,1,1,2,7
mercy,4,1,2,5,2,14
idnnitkhtr,1,0,1,0,0,2
medley,11,6,2,6,10,35
cristobal,1,1,0,0,2,4
binds,1,0,0,0,0,1
iron,1,2,1,2,1,7
contento,1,0,1,0,1,3
contente,0,1,0,1,1,3
astaire,1,0,0,0,1,2
enchanted,1,2,0,2,1,6
lull,1,1,0,0,0,2
homophobicthe,1,0,0,0,0,1
souplesse,0,1,0,1,1,3
strength,1,0,0,1,0,2
genuine,0,2,1,0,0,3
zapando,1,0,1,1,1,4
gief,1,0,1,1,1,4
rome,1,0,0,0,1,2
circles,3,1,2,1,2,9
maiden,0,1,0,1,0,2
passeur,0,0,0,0,1,1
raindrops,1,1,0,1,1,4
phase,2,0,1,2,2,7
grave,0,1,0,0,1,2
izgoem,1,0,0,1,0,2
ouverture,1,1,0,1,2,5
boyfriends,0,1,0,1,0,2
notion,1,0,1,0,0,2
valleyuhh,0,0,0,0,1,1
idjut,1,0,1,1,1,4
brief,1,0,0,0,0,1
rowena,1,0,0,0,0,1
werther,0,1,0,0,0,1
subtle,1,1,1,1,1,5
damen,1,0,0,0,0,1
consciousness,1,1,1,1,1,5
gaffos,1,1,1,1,1,5
deepest,2,1,0,1,2,6
bailando,1,0,1,0,0,2
robaste,0,0,0,0,1,1
haunted,2,0,1,1,2,6
nasty,1,0,1,0,0,2
runs,1,1,2,1,2,7
poppersmonstermix,1,1,0,1,1,4
selchie,1,1,1,1,0,4
damnation,1,0,1,1,1,4
cattle,1,1,0,1,1,4
outerspace,1,1,0,0,0,2
linsidieuse,1,1,1,1,1,5
pastel,0,1,0,0,0,1
away,33,13,19,19,31,115
olvidarme,0,1,0,0,1,2
bien,4,3,0,2,4,13
tainted,1,0,0,1,1,3
itchycoo,1,0,1,0,1,3
infidel,1,0,0,1,0,2
throwdown,1,1,1,1,1,5
veil,1,0,1,1,0,3
asanin,0,1,0,0,0,1
clues,1,1,0,0,1,3
kaboo,1,0,1,1,1,4
kitchen,0,1,0,0,1,2
zoroastrian,1,1,0,0,1,3
climate,1,0,0,0,1,2
complainin,1,1,0,0,1,3
ragtime,1,1,1,0,2,5
jeffreys,1,1,0,1,1,4
carlstedt,1,1,1,1,0,4
evalia,1,0,1,1,1,4
undone,2,0,1,1,2,6
tough,3,1,2,2,1,9
demain,2,0,1,1,0,4
sobchak,1,0,1,1,1,4
fido,1,0,0,0,1,2
jaye,1,1,1,1,1,5
jtknretale,1,1,1,1,1,5
vekha,0,0,0,1,0,1
tony,1,1,0,1,1,4
paradis,1,0,1,0,0,2
speak,2,3,2,3,2,12
shoulda,0,0,0,1,0,1
charisma,0,0,0,1,0,1
gendarmettes,1,0,0,1,1,3
noel,1,1,0,1,1,4
duties,1,0,0,1,0,2
muir,1,1,0,0,0,2
families,1,0,1,1,0,3
beloved,1,1,0,0,1,3
sauer,1,1,1,1,1,5
comfortable,1,0,0,0,1,2
scripka,1,1,1,1,1,5
matsingena,0,0,0,1,0,1
sampson,1,1,0,0,0,2
ehthros,0,0,0,0,1,1
voici,1,1,1,1,1,5
voice,0,2,0,1,0,3
nonfiction,1,0,0,0,1,2
blakes,0,1,0,0,0,1
cont,1,0,0,0,1,2
razamataz,0,0,0,1,0,1
mision,1,0,0,1,1,3
cone,1,1,0,0,1,3
crawlspace,1,1,1,1,1,5
comerte,1,0,0,1,1,3
miya,0,1,1,1,1,4
wheel,2,3,0,4,2,11
independent,1,0,1,1,1,4
hani,1,0,1,1,0,3
raid,1,0,0,1,0,2
saddam,0,1,0,1,1,3
hang,2,0,0,0,1,3
evil,8,3,3,3,4,21
hand,12,7,0,3,9,31
documents,1,0,0,1,1,3
vermont,1,1,0,1,1,4
kept,2,1,0,1,1,5
hopping,1,1,0,1,0,3
orgasme,1,0,0,1,0,2
contact,2,0,1,2,2,7
mamma,1,2,0,0,2,5
musical,2,1,1,1,2,7
indigo,1,1,0,1,1,4
candilejas,1,0,0,0,1,2
photo,0,1,0,1,1,3
fauvrelle,0,0,0,1,0,1
lixuneanos,1,1,1,1,1,5
thanks,0,0,0,0,1,1
victim,1,1,1,0,1,4
antes,0,1,0,0,1,2
lineman,1,1,0,1,1,4
joso,1,1,0,0,1,3
shout,3,3,1,3,3,13
spread,0,1,0,0,1,2
yoyo,1,1,0,0,0,2
righteous,1,0,1,1,0,3
plasma,1,0,1,1,0,3
desire,3,2,1,2,3,11
insensitive,0,1,0,1,1,3
boxed,1,0,0,0,0,1
olimpos,1,1,0,1,0,3
mayo,0,0,0,1,1,2
chumpman,1,0,0,0,0,1
tranes,0,1,0,1,0,2
aubade,1,1,0,0,1,3
rhymney,1,1,1,1,1,5
mille,1,2,0,1,2,6
skanky,1,0,0,0,1,2
cooler,1,0,1,0,0,2
grizzly,1,0,0,0,1,2
theyre,1,0,0,0,1,2
night,46,25,27,32,36,166
webb,1,1,1,1,1,5
korea,2,1,1,1,1,6
jimmies,1,0,0,0,0,1
laakista,1,1,1,1,1,5
born,10,7,1,6,8,32
stardust,0,1,0,1,1,3
salir,1,0,1,0,1,3
indianola,1,0,1,1,0,3
istime,1,1,0,1,0,3
orchid,1,0,1,0,1,3
purple,1,0,1,1,1,4
entropik,0,0,0,1,0,1
messaggero,0,0,0,0,1,1
indoctrination,1,0,0,0,0,1
slavinka,1,0,0,0,0,1
columbus,1,1,0,0,0,2
dolce,1,1,0,1,1,4
sadie,1,0,0,1,0,2
quedo,0,0,0,1,1,2
shogun,1,0,0,0,1,2
charing,1,0,1,0,0,2
queds,1,0,1,1,1,4
post,1,1,0,0,1,3
meseca,0,0,0,0,1,1
coral,1,0,0,0,0,1
months,1,0,0,0,1,2
horizon,1,0,0,1,0,2
azzurro,1,0,1,0,1,3
jacques,3,1,2,1,3,10
carpal,1,0,1,0,1,3
bound,2,3,1,1,1,8
cante,0,0,0,0,1,1
stumble,1,1,1,1,1,5
overtureblue,1,1,0,1,1,4
deception,0,0,0,1,0,1
manzenera,1,1,1,1,1,5
fight,0,0,0,2,1,3
lovesick,1,1,0,1,1,4
basanti,0,0,0,1,1,2
becoming,0,1,0,0,0,1
snows,1,1,0,0,0,2
tinta,0,0,0,0,1,1
reves,1,1,1,2,1,6
solidao,0,1,0,0,0,1
true,12,7,5,5,7,36
cupareree,1,0,0,1,0,2
veiled,1,0,1,1,1,4
shooby,1,0,1,1,1,4
scrimmage,0,1,0,0,1,2
didgeralia,1,1,0,1,0,3
crystal,1,0,1,0,0,2
emit,1,1,1,0,1,4
promises,1,0,1,0,0,2
rerecording,1,0,0,1,1,3
moore,0,0,1,0,0,1
scandalous,1,1,1,0,0,3
stronger,1,1,0,0,1,3
abstract,1,1,1,1,1,5
skvoz,1,0,0,1,0,2
promised,1,0,1,1,1,4
prayer,6,4,4,5,5,24
tumba,1,2,0,1,0,4
dying,7,4,4,4,6,25
victorys,0,0,0,1,0,1
reality,0,0,0,1,0,1
suburban,1,0,0,0,0,1
shrine,1,0,0,0,0,1
test,2,0,2,3,2,9
fairground,1,1,0,0,1,3
welcome,5,3,1,6,8,23
santeleco,0,1,0,0,0,1
belive,0,0,0,1,0,1
tajima,1,1,0,1,1,4
superscout,1,0,1,1,1,4
together,12,9,8,8,11,48
beds,1,1,1,1,1,5
nigun,0,1,0,1,0,2
songs,1,0,0,0,1,2
danco,0,1,0,0,1,2
dance,35,17,15,17,29,113
grateful,1,0,1,0,1,3
battle,6,4,1,5,3,19
birak,0,0,0,0,1,1
zong,0,0,0,0,1,1
zone,4,2,3,2,3,14
donner,1,1,1,1,1,5
flash,1,1,0,1,2,5
motivopop,1,1,0,0,1,3
permanently,1,0,0,0,1,2
rhythm,1,4,0,2,2,9
terror,1,0,1,0,0,2
brown,10,6,5,3,6,30
ihnen,0,0,0,1,0,1
anonymous,1,1,1,1,1,5
kitten,1,1,0,0,1,3
trouble,4,2,1,3,3,13
bamboozle,1,0,0,0,1,2
guitars,1,0,0,0,0,1
pontchartrain,1,1,0,0,0,2
revolution,5,2,2,3,3,15
bedroom,2,1,1,2,1,7
cost,1,1,1,0,0,3
curse,4,1,1,3,2,11
jeric,0,0,0,0,1,1
sleepwalker,1,0,0,0,1,2
scaffold,1,1,0,1,1,4
rockstarslive,1,0,0,1,0,2
uniform,1,1,1,1,1,5
quedar,1,0,1,1,1,4
serban,1,0,0,0,1,2
kusetus,1,0,0,0,0,1
popovic,1,0,0,0,1,2
spinna,1,0,0,0,1,2
sleepwalkers,1,1,0,1,0,3
coochie,1,1,1,1,1,5
change,16,7,5,11,12,51
sending,1,1,1,0,0,3
flames,1,0,1,1,0,3
nievitch,1,1,0,0,1,3
screamin,1,0,0,0,0,1
trial,1,1,0,0,1,3
locomotion,1,1,0,1,1,4
pillow,3,3,1,1,3,11
homecoming,2,0,1,0,2,5
burp,1,0,0,1,1,3
cien,0,0,0,0,1,1
paragon,0,1,0,0,0,1
italiano,1,1,0,1,1,4
uphill,1,0,0,0,0,1
sincerely,1,0,0,1,1,3
stings,2,0,1,1,1,5
should,4,2,2,3,4,15
market,2,0,0,1,0,3
prove,2,1,1,0,2,6
pusher,1,1,1,1,1,5
selecta,1,0,0,1,1,3
live,178,80,97,106,154,615
soki,0,1,0,0,0,1
angels,6,1,3,4,3,17
matador,1,3,0,2,2,8
ukkosenjumalan,1,0,1,1,0,3
entrance,1,1,0,1,1,4
bellini,0,0,0,1,0,1
club,15,4,9,18,16,62
abramz,1,0,0,1,0,2
foxboro,1,0,1,0,1,3
verliebst,1,0,0,1,1,3
niggaz,0,0,0,0,1,1
hope,5,2,4,2,6,19
diddley,1,0,0,0,0,1
jveux,1,0,1,1,1,4
burrinha,0,1,0,0,1,2
heart,44,24,12,29,41,150
dedicated,2,3,1,2,3,11
serus,1,0,1,0,0,2
nema,0,0,0,0,1,1
vnner,0,0,0,1,0,1
noch,1,0,1,1,1,4
topic,1,0,1,1,1,4
heard,5,5,2,3,6,21
chin,0,0,0,0,1,1
chim,0,2,0,2,2,6
airplane,1,0,0,0,0,1
lluvia,1,0,1,0,1,3
lounge,1,0,1,1,1,4
nonstop,0,0,0,1,0,1
zimmerman,1,0,1,0,0,2
sacrifice,1,0,1,1,0,3
southern,1,1,1,2,2,7
stripes,1,0,0,0,1,2
drastic,1,1,0,0,1,3
heroes,1,1,0,0,1,3
acorden,1,0,0,0,1,2
meteores,0,0,0,1,0,1
remember,7,5,4,6,8,30
cubanas,0,1,0,0,0,1
explicit,23,10,3,10,28,74
hifi,1,1,1,1,1,5
nosed,0,1,0,1,1,3
vaya,1,1,0,1,1,4
tagged,1,0,1,0,0,2
tncdallamok,1,1,0,1,0,3
coln,1,0,0,1,1,3
brain,2,1,2,0,1,6
orgullo,0,1,0,0,0,1
cold,10,5,3,6,6,30
still,18,11,12,14,19,74
birds,1,1,0,0,1,3
earplugs,1,0,0,1,1,3
revivalism,1,0,1,1,0,3
willow,1,1,0,1,1,4
dejarte,1,0,1,1,1,4
ducktails,1,0,1,1,0,3
wixa,0,0,0,1,0,1
norway,1,0,1,1,1,4
evol,1,0,0,1,0,2
clasico,0,0,0,0,1,1
guajira,2,2,0,1,1,6
maquina,0,1,0,2,0,3
extrication,1,1,1,1,0,4
hala,1,1,0,1,0,3
adrenaline,1,0,1,1,1,4
halleluja,1,0,1,0,1,3
half,6,1,3,2,4,16
recap,0,0,0,1,0,1
perdu,1,1,0,1,1,4
hall,4,3,1,4,4,16
galloping,1,1,1,1,1,5
wont,6,5,3,6,7,27
concerto,5,3,0,3,5,16
fumes,1,0,1,0,0,2
boheme,0,0,0,0,1,1
james,5,6,1,3,4,19
drop,3,0,1,2,3,9
magan,0,0,0,0,1,1
aquacityboy,1,1,0,1,1,4
desde,1,0,1,2,1,5
stockholm,1,1,1,1,1,5
bhabhiyie,0,0,0,1,0,1
kann,1,1,0,1,1,4
kano,0,1,0,1,0,2
danchall,0,0,0,0,1,1
mangos,0,1,0,0,0,1
hymne,0,1,0,0,1,2
goose,1,0,0,0,1,2
mulher,0,1,0,0,1,2
year,7,1,4,1,7,20
happen,2,2,1,1,1,7
pills,1,0,0,1,1,3
tried,0,0,0,0,1,1
album,362,120,171,146,304,1103
space,8,3,4,4,6,25
llamada,0,0,0,0,1,1
thirst,0,0,0,0,1,1
looking,8,5,3,4,5,25
messiaen,0,0,0,1,0,1
cars,1,0,1,0,1,3
scrooges,1,0,0,0,1,2
medalla,0,0,0,1,1,2
unwanted,1,0,0,0,1,2
caro,0,1,0,0,0,1
marina,1,0,1,1,1,4
cara,0,1,0,1,1,3
marine,0,1,0,0,1,2
trange,1,0,1,1,1,4
card,1,1,0,0,0,2
care,6,2,3,3,2,16
lhemms,1,0,1,1,1,4
goodnights,1,0,0,0,0,1
deprivation,1,0,1,1,1,4
pegadito,1,0,0,0,1,2
blind,2,0,1,0,0,3
ouyounik,0,0,1,1,1,3
jumke,0,0,0,1,0,1
yourself,5,4,3,4,6,22
proibida,1,1,1,1,1,5
ring,4,3,1,0,4,12
tomorrow,11,5,5,8,8,37
size,2,1,1,0,1,5
silent,6,6,1,4,8,25
caught,5,1,2,3,4,15
gardien,1,0,0,0,0,1
rakkahin,1,1,0,0,1,3
vampyyri,1,0,1,1,1,4
friend,11,7,7,5,8,38
mostly,0,1,0,0,0,1
that,46,31,16,25,41,159
brains,1,0,0,0,0,1
crackbabies,1,1,1,0,1,4
qual,1,0,0,1,1,3
quan,0,0,0,0,1,1
hillbillies,1,1,0,0,0,2
flowers,4,3,1,2,6,16
than,18,8,8,10,17,61
rugged,0,0,0,0,1,1
gemstones,1,1,0,0,1,3
vocals,5,1,0,1,4,11
apples,2,2,1,1,2,8
fruits,1,0,0,1,0,2
fruity,0,1,1,0,0,2
angel,18,14,6,13,16,67
vitaminas,1,0,0,0,1,2
boomshackalack,0,0,0,1,0,1
premier,1,1,0,1,1,4
gitanos,2,0,0,2,2,6
slap,1,0,0,1,0,2
loko,1,1,0,1,1,4
anges,1,1,0,1,1,4
insatiable,1,0,0,1,0,2
slab,1,1,0,1,1,4
windsor,0,0,0,1,0,1
jardin,0,1,0,0,1,2
deux,4,3,0,1,4,12
jardins,1,0,1,1,1,4
deus,1,1,1,1,1,5
santiago,2,0,1,1,2,6
prick,1,0,0,0,0,1
price,2,2,1,0,1,6
chorando,0,1,0,0,0,1
america,2,1,2,1,1,7
fersen,1,1,0,1,1,4
destiny,1,0,0,1,1,3
michelle,2,1,2,1,2,8
forever,16,7,12,16,13,64
atfcs,1,0,0,1,1,3
alguna,1,0,0,0,1,2
steady,5,3,2,2,3,15
alfil,1,1,1,1,0,4
verbals,1,1,0,1,0,3
slaves,1,0,1,0,1,3
sexing,1,0,1,1,1,4
rambling,1,2,0,0,1,4
malheureux,1,1,0,1,1,4
ground,3,2,2,2,1,10
aint,29,23,8,15,20,95
title,2,2,1,3,3,11
saints,1,1,0,2,0,4
september,3,2,2,3,3,13
only,26,18,10,19,26,99
sierra,0,1,0,0,0,1
ainm,1,0,0,0,0,1
jole,0,1,0,0,0,1
pumpkin,0,0,0,1,1,2
fledermaus,0,0,0,0,1,1
cannot,1,0,1,1,1,4
cryin,1,1,1,0,2,5
deborahs,1,0,0,0,1,2
leather,1,0,0,1,1,3
imbecile,1,0,1,1,1,4
breeches,1,1,0,0,1,3
losers,1,1,0,1,1,4
criscoteque,1,0,1,1,1,4
musette,2,2,0,0,2,6
amoureux,1,0,0,0,0,1
concert,4,0,4,3,3,14
godere,1,0,0,0,1,2
ends,3,1,3,0,3,10
hoes,0,0,0,1,0,1
maana,1,0,1,0,0,2
troubadour,1,1,1,0,0,3
dompfaff,1,1,0,1,1,4
estar,1,0,0,0,1,2
estas,3,0,1,0,2,6
between,9,1,5,4,7,26
notice,2,1,1,0,2,6
unlocks,1,0,0,0,1,2
widersacher,1,1,0,0,1,3
blame,5,1,1,3,1,11
hurts,2,0,1,0,2,5
comeback,1,1,1,1,1,5
goodsall,1,1,1,1,1,5
impromptu,1,1,0,0,0,2
duet,1,0,1,1,2,5
mona,1,0,0,0,0,1
mono,2,1,0,2,2,7
monk,1,1,0,1,0,3
timour,0,1,0,1,0,2
moni,0,0,0,0,1,1
wheels,1,1,0,1,0,3
prequel,1,1,0,0,0,2
comes,5,5,1,6,10,27
kilometros,0,0,0,0,1,1
madness,2,2,0,2,2,8
plaisancefox,0,1,0,0,1,2
cuando,1,0,1,2,3,7
basilica,1,0,0,0,1,2
taryns,1,1,0,1,1,4
learning,2,1,1,1,2,7
punisher,1,0,0,1,1,3
cycling,0,0,0,1,0,1
sest,1,1,0,0,1,3
cares,4,1,1,2,3,11
cared,0,1,0,1,1,3
informer,1,0,0,1,1,3
scumfrog,1,1,1,1,1,5
foggy,1,1,0,1,1,4
ruby,3,1,1,2,1,8
these,8,2,1,5,6,22
mouton,0,1,0,0,1,2
trick,0,0,0,1,0,1
crump,1,0,0,1,1,3
bogart,0,0,0,1,0,1
bian,1,0,0,0,1,2
sudanese,0,0,1,1,0,2
embrace,0,0,0,0,1,1
heels,2,1,2,1,2,8
return,2,1,1,1,2,7
helium,1,0,0,1,0,2
floating,2,2,2,2,1,9
worry,3,1,0,0,3,7
pastas,1,0,0,0,1,2
esteban,2,0,2,0,2,6
gentlemen,1,2,0,1,1,5
motherless,0,1,0,0,0,1
epoch,1,0,1,1,1,4
finish,1,0,0,0,0,1
arctic,1,0,1,1,0,3
foam,1,1,0,0,0,2
daquitaine,1,0,0,0,1,2
fruit,1,1,1,1,1,5
voulait,1,1,0,1,1,4
wessex,1,1,0,1,1,4
severe,1,0,0,1,1,3
breeze,0,0,0,0,1,1
holli,0,0,0,1,0,1
taxi,1,1,0,1,1,4
frankie,3,1,1,2,2,9
noah,1,0,0,1,1,3
neon,2,0,1,1,2,6
narechenny,1,0,0,1,0,2
civilized,1,1,0,1,1,4
anyday,0,0,0,0,1,1
touch,7,7,3,7,8,32
statues,1,0,1,0,0,2
speed,3,1,1,1,2,8
taxt,1,0,1,1,0,3
death,15,4,4,8,6,37
thinking,1,3,1,1,3,9
daydreaming,1,1,1,2,1,6
cumha,1,1,0,1,1,4
sportin,1,0,0,0,1,2
ilusao,0,1,0,1,1,3
choclate,1,1,0,0,1,3
treatment,0,0,0,0,1,1
verso,1,1,0,1,1,4
role,2,1,0,1,2,6
momentum,1,0,1,0,1,3
real,9,4,6,11,9,39
ditt,0,1,0,0,0,1
envie,1,0,0,0,0,1
rasta,1,0,0,1,1,3
rules,1,0,1,2,0,4
lado,2,0,0,0,0,2
gonna,19,18,12,9,16,74
gamelan,1,0,0,0,1,2
early,2,1,0,0,2,5
listening,1,1,1,0,1,4
earls,1,0,0,0,0,1
execution,1,1,0,1,0,3
lady,6,5,2,4,8,25
koobas,1,1,1,1,1,5
ruled,1,1,0,0,1,3
collapsar,1,1,1,1,1,5
fortune,1,0,0,0,1,2
pounds,0,0,1,0,0,1
greeting,1,1,1,0,1,4
miracle,2,1,3,2,2,10
oblivion,1,0,0,1,0,2
adianta,1,1,1,1,1,5
whatcha,2,0,1,1,2,6
morena,4,5,0,2,5,16
twelve,1,0,0,0,1,2
eddie,0,0,1,1,1,3
betania,0,1,0,0,1,2
ihmisen,1,0,1,1,1,4
recorded,1,1,0,1,0,3
guillaume,1,0,0,0,1,2
hustla,0,0,0,1,1,2
willie,3,1,1,2,2,9
hustle,0,0,0,0,1,1
ohios,1,0,1,1,1,4
business,4,1,1,4,3,13
sixth,1,0,1,1,1,4
neurtica,1,0,1,0,1,3
credits,1,0,1,0,0,2
artie,0,1,0,0,0,1
innocence,2,0,0,1,2,5
raul,2,1,0,1,2,6
francis,0,1,0,0,1,2
throw,1,1,1,2,1,6
brighton,0,1,0,0,0,1
aphrodite,1,0,1,0,0,2
central,1,1,1,1,1,5
lombrigas,1,1,1,1,1,5
chop,1,0,1,0,0,2
journey,2,3,0,2,5,12
assassin,1,0,1,1,0,3
sketches,0,1,0,0,0,1
mirame,0,1,0,1,1,3
youd,2,0,2,1,1,6
zambele,0,1,0,1,1,3
prospection,0,0,0,1,0,1
morir,0,0,0,1,1,2
bedtime,1,0,0,0,1,2
operator,2,2,1,1,2,8
your,92,55,46,77,76,346
semba,0,1,0,1,1,3
stare,2,1,2,2,0,7
area,0,0,0,0,1,1
weekend,1,0,0,0,0,1
start,9,1,4,3,6,23
ares,1,1,0,1,0,3
stars,8,3,6,7,9,33
shagi,0,0,0,1,1,2
copacabana,0,1,0,1,0,2
grandbags,1,0,1,1,1,4
caviglia,1,0,1,1,0,3
trying,2,2,0,0,2,6
stickin,1,0,0,0,1,2
porcelaine,1,1,1,1,1,5
opression,1,0,0,0,0,1
tellin,1,1,0,1,0,3
sadness,0,0,0,1,0,1
aneurysm,1,0,1,0,0,2
troyano,1,1,0,0,0,2
araby,1,1,0,1,1,4
tengo,0,0,0,0,1,1
mover,1,0,0,0,0,1
superconfidential,1,0,0,1,0,2
completeness,1,1,0,1,1,4
todo,4,2,2,3,4,15
songgreat,1,0,0,0,0,1
tirador,1,1,0,1,1,4
dimanche,1,1,0,0,2,4
fools,4,1,3,2,2,12
poor,3,2,2,1,3,11
diaries,1,1,1,0,1,4
yippiyoay,1,0,0,1,1,3
time,68,38,28,39,55,228
desclaves,1,1,0,1,1,4
pooh,0,1,0,0,0,1
airheads,1,0,1,1,1,4
pool,1,1,0,1,1,4
building,3,1,2,1,1,8
tacuta,1,0,0,1,0,2
volcn,0,0,0,1,1,2
moonlight,2,4,0,4,4,14
bystander,1,0,1,1,0,3
youngblood,1,1,0,1,1,4
offishall,0,1,0,0,1,2
parabolics,0,0,0,2,0,2
cruisin,1,1,0,1,1,4
decelerate,1,0,1,0,0,2
tomorrows,1,0,0,0,0,1
fleurs,1,1,0,1,1,4
govinda,1,1,0,1,1,4
ciudad,0,0,0,0,1,1
monts,0,1,0,0,1,2
corps,1,4,0,2,1,8
bosque,1,1,1,1,0,4
hablo,0,1,0,0,0,1
fountain,0,1,0,0,1,2
dekh,1,0,1,1,1,4
vers,2,1,1,2,1,7
bazooka,1,1,1,1,1,5
ventilador,1,1,0,1,1,4
witching,1,1,0,1,1,4
vera,1,1,0,1,1,4
rogue,1,1,0,1,1,4
decide,1,1,0,1,1,4
decidi,0,0,0,0,1,1
heaven,13,9,7,10,13,52
louis,1,1,0,0,1,3
nortena,1,0,0,0,1,2
locomotive,1,0,1,1,1,4
louie,2,0,2,1,0,5
colossal,1,0,1,0,0,2
streets,4,4,1,2,4,15
cibola,1,0,1,1,1,4
conscience,1,1,1,1,1,5
ails,0,0,0,1,0,1
apologizes,1,1,0,1,0,3
darkness,4,2,3,3,3,15
consumers,1,1,1,1,0,4
nana,2,1,0,0,1,4
maybes,1,1,0,1,0,3
onni,1,1,1,1,1,5
learned,1,0,1,0,0,2
edited,4,2,0,3,6,15
unuturum,0,0,0,0,1,1
sarankgni,0,1,0,1,1,3
loose,3,0,1,2,2,8
answers,3,1,2,2,3,11
tracks,1,0,1,0,0,2
signapur,1,0,0,0,0,1
brillantin,1,1,0,1,1,4
meisten,0,0,0,0,1,1
strong,2,0,0,0,1,3
arena,2,2,1,1,2,8
ahead,1,0,1,0,0,2
perfidia,0,1,0,0,1,2
reason,4,1,2,1,3,11
soldier,1,0,1,0,1,3
coeurs,1,1,0,1,1,4
tralala,1,1,0,0,1,3
shuffle,5,4,0,4,4,17
family,1,0,0,2,3,6
setanta,1,1,0,1,1,4
khan,0,0,1,1,1,3
takes,8,4,3,2,8,25
amaze,0,0,0,2,0,2
pantin,1,1,0,0,1,3
taken,1,0,0,0,0,1
remixes,1,0,0,2,1,4
instrumental,16,12,7,12,11,58
excuse,1,1,0,1,1,4
broke,4,1,2,1,2,10
dios,1,1,0,2,2,6
hurry,3,1,3,3,2,12
brokn,1,0,1,0,0,2
grill,0,0,0,0,1,1
legba,1,1,0,1,1,4
nina,2,2,2,2,3,11
minhas,1,1,0,0,1,3
nine,2,0,1,2,1,6
hermione,1,1,0,0,0,2
nino,0,1,0,1,2,4
history,4,1,1,1,1,8
albi,0,0,1,1,1,3
sharab,0,0,0,0,1,1
albo,1,1,0,1,1,4
dragonfly,2,0,1,0,0,3
veinte,0,1,0,1,1,3
daddys,1,1,1,1,1,5
chagallos,0,0,0,0,1,1
cows,1,0,1,1,1,4
phrase,1,1,0,1,1,4
zanzibar,1,0,0,0,0,1
liebe,0,0,1,1,0,2
warhead,1,0,0,0,0,1
limosna,0,0,0,1,1,2
stayed,1,1,0,1,1,4
snippet,1,0,1,0,0,2
calme,0,0,0,1,1,2
paloma,0,0,0,0,1,1
eterno,1,0,0,1,1,3
rude,0,0,0,1,0,1
santilln,1,1,0,0,0,2
tries,1,1,0,1,0,3
invasion,1,1,0,1,1,4
rudy,1,3,0,3,0,7
compulsory,0,0,1,0,0,1
anytime,1,0,0,0,2,3
dread,0,0,0,1,0,1
dream,24,12,15,17,19,87
penda,0,0,0,0,1,1
help,10,3,4,8,8,33
nightsoftly,1,1,0,0,1,3
soon,2,1,1,1,1,6
held,0,1,0,0,1,2
soot,1,1,1,1,1,5
hell,12,3,6,3,8,32
markie,1,1,1,1,0,4
prowler,1,0,0,1,1,3
arbolitos,1,1,0,1,1,4
cloches,1,0,0,1,1,3
friscia,1,0,0,1,1,3
absence,0,0,0,1,0,1
lontana,1,0,0,0,1,2
peanuts,0,2,0,1,1,4
fool,6,2,1,3,3,15
evening,2,3,0,2,3,10
food,2,2,0,1,2,7
foot,1,1,0,1,0,3
ninja,3,1,2,3,3,12
hammersmith,1,0,0,1,1,3
cadenza,1,0,0,1,1,3
fully,1,1,1,1,0,4
bless,1,3,1,1,2,8
decimas,1,0,0,1,1,3
roadage,1,0,0,0,0,1
mewith,1,1,0,1,1,4
restless,0,1,0,1,0,2
hiroteros,0,0,0,0,1,1
toda,0,1,0,0,1,2
quantum,1,0,1,1,0,3
infinity,3,1,1,3,2,10
neir,1,0,0,1,1,3
beyond,4,2,2,2,1,11
conker,0,0,0,1,0,1
anarchy,1,0,0,0,0,1
vertigo,1,1,1,1,1,5
basements,1,0,0,1,1,3
miss,7,2,6,4,4,23
robert,2,1,0,1,1,5
since,3,2,2,2,3,12
chiove,1,0,0,0,0,1
testify,1,0,1,1,1,4
wolverine,1,1,0,0,1,3
pemba,0,1,0,0,0,1
safety,1,0,1,0,0,2
shuncata,0,0,0,0,1,1
drink,1,1,0,2,1,5
rednosed,1,1,0,1,1,4
bass,5,1,4,5,2,17
dirt,1,1,0,0,0,2
mentimos,0,0,0,0,1,1
dune,0,1,0,1,1,3
tipota,0,0,0,0,1,1
brightess,0,1,0,1,0,2
ironhead,0,0,1,0,1,2
selon,0,0,0,1,0,1
montagnes,1,1,0,0,1,3
gwithian,1,1,0,1,0,3
gonewine,0,0,0,0,1,1
kazmeyer,1,1,1,1,1,5
terrible,1,1,0,1,1,4
americas,1,0,1,0,1,3
bancate,1,0,1,1,1,4
american,7,3,3,4,5,22
daisy,1,0,0,1,1,3
heartbeat,1,0,0,0,0,1
xiang,0,0,0,1,4,5
malki,1,0,1,1,1,4
knots,1,1,1,1,0,4
ville,1,0,0,0,0,1
kaliforneyea,1,1,0,0,0,2
coloreteada,1,0,0,0,1,2
mist,1,1,0,1,1,4
visions,3,4,2,4,2,15
rorys,1,1,1,1,1,5
horse,6,1,2,0,5,14
pinned,1,0,1,0,0,2
eddy,0,0,0,0,1,1
station,2,1,0,2,1,6
gibraltar,1,0,1,0,1,3
handshakes,1,0,1,0,1,3
nigeria,0,0,0,1,1,2
banana,1,1,0,1,0,3
selling,1,1,0,0,0,2
trapped,0,0,0,1,0,1
norma,0,0,0,1,0,1
jamie,2,2,1,2,1,8
magali,1,1,0,1,1,4
overdrive,1,0,1,0,1,3
jordan,0,1,0,0,1,2
shifter,1,0,1,1,1,4
authors,1,0,0,0,0,1
translation,1,0,0,1,0,2
lament,6,3,2,4,5,20
grey,1,0,0,0,1,2
vitalized,1,0,1,0,0,2
maga,1,0,0,0,1,2
izgaryam,1,0,0,0,1,2
mahmouds,0,1,0,0,0,1
humppa,3,2,2,2,2,11
apagon,1,0,1,1,1,4
juice,1,0,0,0,1,2
eternamente,0,0,0,0,1,1
bubulina,1,0,1,1,1,4
poulet,1,0,1,1,1,4
ultrafunk,1,1,1,1,1,5
jour,1,1,1,1,1,5
cherokee,1,0,1,0,0,2
trance,1,1,1,1,1,5
cave,2,2,0,3,2,9
cava,1,1,0,1,0,3
tinghi,1,1,1,1,0,4
nuestras,0,0,0,0,1,1
towards,1,0,1,1,0,3
appapas,1,1,0,1,1,4
freddie,2,2,0,2,2,8
aires,1,0,0,0,1,2
aljarafe,1,0,0,1,1,3
alpha,1,1,0,1,1,4
mack,1,1,0,0,1,3
beachport,1,0,1,1,1,4
minha,0,1,0,0,1,2
clear,1,0,1,3,3,8
blent,0,0,0,0,1,1
ziggy,1,0,0,0,1,2
clean,3,0,0,0,1,4
hips,1,0,0,0,1,2
ekloges,1,0,0,1,1,3
danza,1,1,0,1,0,3
ingenting,1,1,1,1,1,5
sheik,1,1,0,1,1,4
garantito,0,0,1,1,0,2
crayon,1,1,0,1,1,4
heavens,3,1,0,0,2,6
blackwords,1,0,1,1,0,3
northern,1,0,1,0,1,3
justice,1,0,0,0,0,1
less,2,1,2,3,1,9
quem,0,1,0,1,1,3
randy,1,1,1,1,1,5
pretty,6,2,5,3,4,20
hardened,1,0,1,1,1,4
circle,3,3,2,2,3,13
bigbigkiss,1,0,1,1,1,4
trees,4,4,2,3,4,17
strut,1,0,0,0,0,1
famous,2,0,2,1,2,7
feels,2,2,0,2,3,9
during,1,1,0,2,0,4
molten,0,0,0,1,0,1
catcher,1,0,1,1,1,4
graysinn,1,0,0,1,0,2
vingt,1,1,0,0,1,3
geld,1,0,0,1,1,3
regreses,0,0,0,1,1,2
seventeen,1,0,1,1,2,5
backtrack,1,1,0,0,0,2
throwing,1,0,0,0,1,2
plough,0,1,0,1,0,2
ctait,1,1,0,1,1,4
culture,1,0,1,1,0,3
bethlehem,1,1,0,1,1,4
portrait,1,2,2,0,0,5
angie,1,0,0,0,1,2
pish,1,0,0,1,1,3
termites,0,0,0,1,1,2
bride,1,1,0,1,1,4
pictures,1,1,1,0,1,4
enger,1,0,0,0,0,1
engel,1,1,1,1,1,5
stall,1,0,0,1,1,3
marcando,1,0,0,0,1,2
tappin,1,0,1,0,1,3
deil,0,1,0,1,0,2
piss,1,0,0,0,0,1
missing,6,1,2,6,2,17
dejaria,0,1,0,0,0,1
invisible,1,0,0,0,1,2
speilet,0,1,0,0,0,1
cassard,0,1,0,0,1,2
secrets,1,0,0,1,1,3
perkiomen,1,0,0,0,1,2
anos,0,0,0,0,1,1
keybdbpremiere,1,0,1,0,1,3
remastering,0,0,0,0,2,2
halintamyymln,1,0,1,1,1,4
forgotten,2,1,0,1,1,5
hbar,1,0,1,1,1,4
hackers,1,0,0,1,0,2
battery,0,1,0,1,0,2
steele,1,1,0,0,1,3
whatever,2,0,2,1,1,6
quiera,0,1,0,0,0,1
capleton,1,1,0,1,0,3
likes,1,1,0,1,1,4
sailboat,0,1,0,0,1,2
celluloid,1,0,0,0,1,2
fabolous,1,0,0,0,1,2
destructor,1,0,1,1,0,3
wasnt,1,0,0,0,0,1
damn,2,0,1,1,2,6
militar,1,0,1,1,1,4
empty,4,1,1,2,2,10
dame,2,2,0,2,2,8
dialogue,3,1,0,0,1,5
lived,0,0,0,1,0,1
chimrique,1,1,0,1,1,4
chasseurs,1,1,0,1,1,4
abajo,0,0,0,1,1,2
else,1,0,1,0,1,3
katherine,1,0,0,0,1,2
heute,1,0,1,1,0,3
peyote,1,0,1,1,1,4
envers,1,1,1,1,1,5
valkyria,1,0,0,1,0,2
look,8,6,3,3,8,28
bikini,1,0,0,1,1,3
ropa,1,0,0,0,1,2
chariots,1,1,0,1,1,4
luciano,2,1,1,2,2,8
alte,1,1,1,1,1,5
loop,4,3,2,4,3,16
pack,1,0,0,3,3,7
lagan,0,0,0,1,0,1
pantera,1,0,1,1,1,4
wildflowers,1,0,0,0,1,2
smacker,0,1,0,1,0,2
ready,4,2,1,7,5,19
guido,1,0,0,1,1,3
orfvres,1,0,1,1,1,4
anymore,6,1,1,3,5,16
terras,2,2,0,2,2,8
dormilones,0,1,0,0,1,2
subliminal,1,1,0,1,0,3
syleena,0,0,0,0,1,1
grand,3,5,2,4,4,18
estes,1,0,1,0,0,2
drmmen,0,1,0,0,0,1
composition,1,1,1,1,1,5
used,2,2,1,1,2,8
dime,1,1,0,1,2,5
bonus,17,4,4,12,11,48
haunting,2,0,0,1,1,4
adrift,1,0,0,0,1,2
yuan,0,0,0,0,1,1
older,1,1,1,1,1,5
obviously,1,0,0,0,0,1
five,5,5,1,3,3,17
coup,1,1,1,2,2,7
cour,1,1,0,1,1,4
choro,1,2,1,2,2,8
sovra,1,0,0,1,0,2
praying,1,1,0,0,1,3
afro,1,0,1,1,1,4
caray,2,0,1,1,2,6
nikki,1,1,1,1,1,5
carat,1,1,0,1,1,4
cheryl,0,1,0,1,0,2
soliloquy,0,1,0,0,1,2
march,4,4,1,2,5,16
marca,1,1,0,1,1,4
albino,1,0,1,0,0,2
game,4,4,1,4,3,16
dearly,1,1,0,0,1,3
wings,4,3,4,3,5,19
laccordoniste,1,1,1,1,1,5
mantrol,1,1,1,1,0,4
superbird,1,1,1,1,1,5
baari,1,0,0,1,1,3
weinen,1,1,0,1,1,4
signal,0,0,0,1,0,1
donny,0,1,0,1,0,2
donne,0,0,0,1,1,2
suitcase,1,0,0,0,1,2
cones,0,0,1,0,0,1
brampton,2,1,1,2,1,7
autres,3,2,0,2,3,10
creation,2,1,1,2,2,8
some,12,6,6,6,11,41
osorio,1,0,0,1,1,3
lips,1,0,1,0,0,2
fanfara,1,1,0,1,1,4
debri,1,0,0,1,0,2
civilization,1,0,0,0,0,1
winterlight,0,1,0,1,0,2
bladecrash,1,1,1,1,1,5
squirrel,1,1,0,1,0,3
eruption,1,0,0,0,1,2
processing,1,0,1,1,1,4
lakes,1,1,0,0,0,2
jazzy,0,1,0,0,1,2
step,7,3,2,3,4,19
panhandle,1,0,1,0,1,3
contessa,0,1,0,1,0,2
shine,4,5,1,2,4,16
faith,4,1,0,1,3,9
padam,0,2,0,0,2,4
wouldnt,3,1,1,1,2,8
bleue,0,0,0,1,1,2
yiri,2,0,0,2,0,4
bloco,0,1,0,0,0,1
shiny,1,0,0,0,0,1
silence,5,0,3,3,2,13
seeing,1,0,0,0,1,2
visit,1,0,0,1,1,3
crying,3,2,2,2,2,11
grella,0,0,0,1,0,1
rolls,1,1,0,1,1,4
heritage,1,0,0,1,1,3
kamikaze,1,0,1,1,1,4
bossa,0,1,0,1,0,2
brazos,1,1,0,0,0,2
authority,1,0,0,0,1,2
reef,0,1,0,0,0,1
russian,1,1,1,0,1,4
skull,1,0,0,0,0,1
accustomed,2,2,2,0,2,8
conguitos,0,1,0,0,1,2
loving,11,6,5,9,11,42
chelsea,1,1,1,1,1,5
necesito,0,0,0,0,1,1
moonless,0,0,0,2,0,2
selfhelp,1,1,0,1,0,3
psychopath,1,0,0,0,0,1
cotton,1,0,0,1,0,2
varga,0,0,0,1,0,1
jamboree,0,0,0,0,1,1
objection,1,0,0,0,1,2
creeper,1,0,1,1,1,4
prerogative,1,0,0,1,1,3
recordar,1,0,0,1,0,2
beholder,1,0,0,0,0,1
zither,0,1,0,1,0,2
smiles,1,1,1,1,0,4
everybodys,5,3,2,1,3,14
vivace,1,0,0,1,2,4
william,1,0,0,1,0,2
drag,1,0,1,0,0,2
wohr,1,0,0,1,1,3
naheen,0,0,0,1,0,1
neill,1,1,0,1,1,4
druzya,0,0,0,1,1,2
mentira,2,0,1,1,2,6
beholden,1,1,0,0,1,3
katz,1,1,1,1,1,5
washy,1,1,0,0,0,2
dreidel,4,0,4,0,0,8
psyche,1,1,0,1,0,3
wakabam,1,1,1,1,1,5
marchant,0,1,0,1,0,2
aria,1,0,0,1,1,3
gorilles,0,0,0,1,1,2
nose,1,0,1,0,1,3
does,4,1,1,0,4,10
suite,4,3,1,3,3,14
virtuous,0,0,0,1,0,1
murderous,0,0,0,1,1,2
springpart,0,1,0,0,0,1
wave,5,1,1,4,3,14
cellular,1,0,1,1,1,4
telling,1,0,0,0,1,2
bravest,0,0,0,0,1,1
stiff,1,0,1,1,1,4
button,1,1,0,0,1,3
tokyo,2,0,0,2,0,4
michael,4,2,0,3,3,12
sannyasin,1,0,0,0,1,2
barbara,0,1,0,0,0,1
oopsi,1,0,0,1,1,3
booty,0,0,0,1,0,1
boots,2,0,0,0,2,4
dormire,1,0,0,0,1,2
jump,6,5,4,3,5,23
booth,1,1,0,0,0,2
picked,3,0,2,3,0,8
colonel,1,1,1,1,1,5
sangria,0,1,0,0,1,2
cell,3,0,2,1,1,7
rotten,1,1,1,1,1,5
playa,0,0,0,1,1,2
grenouilles,0,1,0,0,0,1
cela,0,0,0,1,0,1
stance,1,1,0,1,1,4
commercial,2,2,2,2,2,10
chant,2,1,0,2,2,7
coracao,1,1,0,0,0,2
biter,1,0,1,0,0,2
peyte,1,0,0,1,0,2
geng,0,0,0,0,1,1
nameless,1,0,1,1,1,4
salvation,1,0,1,2,0,4
claro,1,1,1,0,1,4
daybreak,0,0,0,1,0,1
clark,1,1,0,0,0,2
lords,0,1,0,0,0,1
clare,0,2,2,0,0,4
mcdermotts,0,0,0,2,0,2
singing,1,1,0,0,1,3
burbullas,0,0,0,1,0,1
cloud,2,2,1,3,2,10
redwing,1,1,0,1,1,4
snoop,0,0,0,0,1,1
remains,2,2,2,1,2,9
crab,1,0,0,0,0,1
zornig,0,0,0,1,0,1
pickney,1,0,0,1,1,3
poppea,1,0,0,0,1,2
started,0,0,0,2,2,4
confused,1,0,0,0,0,1
vuelta,1,0,0,0,0,1
biblicas,0,0,0,0,1,1
justin,3,1,0,0,3,7
crosses,0,0,0,1,0,1
aamutoimet,1,0,1,1,1,4
huesos,0,1,0,1,1,3
ride,13,7,8,9,10,47
crossed,0,0,0,1,0,1
meet,4,1,1,2,4,12
control,8,3,6,2,5,24
votre,0,1,0,0,0,1
halloween,2,0,0,1,3,6
pulling,0,0,0,0,1,1
heut,1,1,1,1,1,5
wonderful,3,4,1,4,3,15
kenna,1,0,1,0,1,3
langem,1,0,1,1,1,4
theydon,1,1,1,1,1,5
talar,1,0,0,1,0,2
vibe,0,1,0,0,0,1
chevrolet,1,0,0,0,1,2
clair,1,0,0,2,2,5
frontiers,1,1,1,1,1,5
gritos,1,1,0,0,0,2
knnykk,1,0,0,1,1,3
thtre,1,1,0,1,1,4
introchamber,1,0,0,0,1,2
valokeilojen,1,0,1,1,1,4
farm,3,2,2,2,0,9
bettinghaus,1,0,1,1,1,4
sewell,1,1,0,0,0,2
spelling,0,1,0,1,0,2
scoob,0,0,1,1,0,2
ramblin,0,0,1,0,0,1
xenophobic,1,0,1,0,1,3
samaritanas,0,0,0,0,1,1
corral,1,0,0,0,1,2
raliste,0,0,0,0,1,1
vapauden,1,0,0,1,1,3
weiners,0,0,0,1,0,1
unbreakable,0,1,0,0,1,2
harajuku,1,0,0,0,1,2
spero,0,0,0,0,1,1
slickers,1,0,0,1,0,2
cuestion,0,0,0,0,1,1
calliope,1,1,0,1,1,4
outer,1,0,0,0,0,1
broom,1,0,0,1,1,3
dancin,1,1,1,1,1,5
cavalleria,1,1,1,1,1,5
takao,1,1,0,1,1,4
doodlin,0,1,0,0,0,1
lindas,1,1,1,1,1,5
breezin,0,0,0,0,1,1
camino,1,0,0,1,1,3
lightnin,1,1,0,0,1,3
placid,0,0,0,2,0,2
hands,6,3,3,4,8,24
sweety,1,1,0,1,1,4
handz,1,1,0,1,1,4
plecaciunea,1,0,0,1,0,2
masters,1,0,0,0,0,1
rahzel,0,1,0,0,1,2
university,2,0,0,2,2,6
hootchie,1,0,0,1,0,2
hacer,2,0,0,0,3,5
candela,1,2,0,1,1,5
blarneyformasian,1,0,1,1,0,3
splitloop,1,0,0,1,0,2
illuminate,0,0,0,1,0,1
warten,1,1,1,1,1,5
baroudeur,1,1,0,1,1,4
sands,1,1,1,1,1,5
morton,0,1,0,0,1,2
special,9,4,5,7,7,32
ricks,1,0,0,1,0,2
fathom,1,1,0,1,1,4
ricky,1,0,0,0,1,2
hardway,0,0,0,1,0,1
chatma,1,0,1,0,0,2
wich,1,1,1,1,2,6
umbrella,2,0,0,1,2,5
flamme,1,1,0,0,1,3
marea,1,0,1,1,1,4
interplanetary,1,1,0,0,1,3
segredo,1,1,0,0,0,2
wizard,0,1,0,0,1,2
negros,0,0,0,0,1,1
printemps,1,2,0,0,2,5
princess,1,0,0,1,0,2
drowning,1,0,1,0,0,2
route,1,0,1,1,0,3
gallina,1,0,0,0,1,2
keep,11,9,5,10,13,48
stride,1,0,0,1,0,2
complainingremixjam,1,0,0,0,1,2
kitteldags,1,0,0,1,1,3
svedomi,1,1,1,0,1,4
buckle,1,1,1,0,1,4
bambenella,0,0,0,0,1,1
sonnenfreunde,0,0,0,1,0,1
congo,1,1,0,0,1,3
bitch,2,1,2,2,2,9
sosa,1,0,0,0,0,1
quality,1,1,1,0,1,4
hiding,2,0,0,0,1,3
fella,1,0,1,1,0,3
bears,1,0,0,0,1,2
africanas,1,1,1,1,1,5
wrapper,1,0,0,1,0,2
foldiv,0,0,0,1,0,1
boken,1,0,0,0,0,1
quieras,0,0,0,1,2,3
wrapped,1,0,0,0,1,2
final,6,4,2,5,9,26
frustration,1,1,1,1,1,5
urbania,0,0,0,0,1,1
huan,0,0,0,0,1,1
listo,1,0,1,0,0,2
dyna,0,1,0,1,1,3
masking,1,0,1,1,0,3
waist,0,0,0,1,0,1
splendido,1,1,0,1,1,4
damaja,0,1,0,0,0,1
assouf,1,0,1,0,0,2
dumb,2,2,1,1,2,8
kitties,1,0,1,1,1,4
drunk,2,1,1,2,1,7
close,5,3,3,5,6,22
need,23,13,13,19,20,88
sacre,0,1,0,0,0,1
sacra,0,1,0,1,0,2
dolorosa,1,0,1,1,1,4
bastard,1,0,0,0,0,1
enqute,1,0,0,1,1,3
jaunt,0,1,0,0,0,1
singe,1,0,0,1,1,3
singh,1,0,1,1,1,4
brand,0,0,0,0,1,1
discos,0,0,0,1,0,1
intentions,2,0,1,0,2,5
duele,1,1,0,0,0,2
kanaria,1,0,0,1,1,3
lultimo,1,0,0,0,1,2
stereo,3,1,2,3,2,11
beatnuts,0,1,0,1,0,2
upset,1,1,0,1,1,4
silenzio,1,1,1,1,1,5
astonishing,1,0,1,0,1,3
kaloobafak,1,0,0,0,1,2
snapshot,1,0,1,1,1,4
indo,0,0,0,1,1,2
wagoners,1,0,0,0,1,2
hitaat,1,0,1,1,1,4
desiluso,1,1,0,0,1,3
anyway,1,0,0,1,1,3
poesa,1,0,1,1,1,4
doigts,1,0,1,1,1,4
soldiers,1,0,0,0,0,1
lowlands,1,1,1,0,1,4
serpentarius,0,0,0,1,0,1
unfinished,1,2,0,1,1,5
acension,1,1,1,1,0,4
brighten,1,0,0,0,1,2
arabian,1,0,1,1,1,4
creamer,0,0,0,1,0,1
libre,1,1,0,1,1,4
fuel,1,1,0,0,0,2
infernal,0,0,1,0,0,1
heartshaped,1,0,1,0,0,2
collinerodolfoschaunardchildrentownspeoplemusetta,0,1,0,0,0,1
lynn,0,0,0,0,1,1
deine,0,0,1,1,0,2
exaltation,1,0,1,0,1,3
murphey,1,1,0,1,0,3
joint,1,1,1,1,1,5
leben,1,1,1,1,1,5
years,5,2,2,2,1,12
borin,1,0,0,0,0,1
endless,4,0,2,1,1,8
evolution,1,0,1,1,1,4
tobacco,1,0,1,0,0,2
gras,2,2,0,0,2,6
benzer,0,1,0,0,1,2
gran,2,0,0,1,1,4
dangerous,2,1,1,1,2,7
grad,3,1,1,2,3,10
grae,1,0,0,1,1,3
preach,1,0,0,0,1,2
gillum,0,1,0,0,0,1
mewerthercharlotte,0,1,0,0,0,1
nuttin,0,0,0,1,0,1
prayers,0,1,0,0,0,1
faroe,0,1,0,1,0,2
pitch,1,1,0,1,1,4
tromorckbank,1,1,1,1,0,4
shaan,1,1,1,1,1,5
freeze,2,1,1,1,2,7
humano,0,1,0,1,0,2
computer,2,1,0,2,2,7
desperate,1,0,0,0,1,2
sensualite,0,0,0,1,0,1
danger,2,0,0,0,0,2
skylark,0,1,0,1,1,3
nightmare,2,0,0,0,0,2
dundee,0,1,0,1,1,3
remembergreat,1,1,1,1,1,5
state,2,1,0,1,2,6
caja,0,1,0,0,1,2
joyo,1,0,0,0,1,2
tyre,1,1,0,1,1,4
horrible,1,0,1,1,1,4
sabotage,1,0,0,0,0,1
llamado,0,0,0,0,1,1
dogon,0,0,0,1,0,1
buckets,1,1,0,0,0,2
kicking,1,0,0,0,0,1
merry,3,4,1,2,4,14
approval,1,0,1,0,0,2
precious,3,3,0,1,3,10
sextetgilded,1,1,0,1,0,3
solace,1,0,0,1,0,2
fishin,2,2,0,0,2,6
hits,1,0,1,1,1,4
beenie,1,1,1,1,1,5
career,3,2,3,2,2,12
minds,1,0,1,0,1,3
subcode,1,1,1,1,0,4
mudhump,1,1,1,1,0,4
dominique,1,1,0,0,1,3
tuesday,1,2,0,1,1,5
harmonic,1,1,1,1,1,5
harmonia,2,0,0,2,0,4
denise,2,2,2,2,0,8
freaxxx,1,0,1,1,1,4
kings,1,1,0,0,1,3
wyclef,1,0,0,0,2,3
erased,1,0,0,1,1,3
quit,2,1,0,1,1,5
stompin,0,1,0,1,1,3
polka,1,2,0,0,1,4
cent,2,1,1,2,2,8
slowly,2,0,2,1,2,7
treat,2,1,1,2,2,8
whisper,1,1,0,0,1,3
ship,2,3,0,2,3,10
mdchen,1,1,0,1,1,4
senses,1,0,0,0,1,2
oversleeping,1,1,0,1,1,4
trebraruna,1,0,0,0,0,1
shameless,1,0,0,1,1,3
bahama,0,1,0,0,0,1
harder,1,1,0,1,1,4
chamar,1,1,1,1,1,5
tuggathanug,0,0,0,1,0,1
rudedrum,1,1,1,1,1,5
enamorate,1,1,0,1,1,4
simons,1,0,0,1,0,2
demo,20,7,9,8,9,53
aurle,1,1,0,1,1,4
swinging,2,2,0,1,2,7
hearted,3,1,1,2,3,10
bucks,1,1,1,1,1,5
goodfellas,0,1,0,0,0,1
shooting,1,0,1,0,2,4
parte,1,0,0,0,1,2
chante,1,0,0,0,0,1
balloon,0,0,0,0,1,1
parto,2,2,0,2,3,9
strange,4,4,1,3,4,16
speaker,0,0,0,1,1,2
underground,1,0,1,1,1,4
party,17,7,9,11,14,58
buzz,0,1,0,0,0,1
nightly,1,0,0,1,1,3
paechar,1,1,0,1,1,4
magician,1,1,0,1,0,3
isch,1,1,1,1,0,4
destruction,3,1,1,3,3,11
poultry,0,0,0,1,0,1
obstacles,1,0,0,0,0,1
well,6,4,1,5,3,19
guidum,0,1,0,0,0,1
senza,1,0,1,0,0,2
onda,1,0,1,1,1,4
underdog,2,0,1,1,2,6
flies,2,1,2,2,2,9
distant,1,4,0,3,1,9
laurel,0,0,0,0,1,1
devient,1,0,1,1,1,4
femme,1,1,1,0,2,5
tontos,1,0,0,0,1,2
fasttrack,1,1,1,1,1,5
stratus,1,0,1,0,0,2
vida,4,5,1,5,5,20
patricia,1,1,1,0,1,4
reasons,1,1,0,0,1,3
atrapado,1,1,0,1,1,4
kick,4,2,3,1,3,13
jesper,1,0,0,0,0,1
livin,8,5,4,4,4,25
fate,1,1,0,0,1,3
crushed,0,0,1,1,0,2
amthran,0,1,0,0,0,1
burden,2,0,1,1,2,6
guerrier,1,1,0,0,1,3
lincoln,1,1,0,0,1,3
renegade,1,0,1,1,1,4
lost,16,4,6,13,10,49
fingerprints,1,0,1,1,1,4
fernando,1,1,0,1,1,4
candy,1,1,1,1,0,4
peixes,1,1,0,1,0,3
lose,5,3,3,2,2,15
japjit,0,1,0,1,0,2
rote,1,1,1,1,1,5
regresar,1,0,0,0,1,2
seigneur,0,1,0,1,0,2
retrato,0,0,0,1,0,1
hush,0,1,0,0,1,2
francisco,1,2,1,2,3,9
shes,14,6,5,3,6,34
shep,1,1,0,0,1,3
cleveland,2,0,0,1,2,5
voadora,0,0,0,1,0,1
petes,0,2,0,2,2,6
heartache,1,1,1,1,1,5
filero,1,1,0,1,1,4
broad,1,0,1,1,1,4
kettle,1,0,0,0,0,1
hannos,1,1,0,1,1,4
cradle,1,0,0,1,1,3
wendy,1,1,1,0,1,4
desejos,1,1,0,1,1,4
tides,1,0,1,0,0,2
coated,1,1,0,2,1,5
reaching,1,1,0,1,1,4
puede,1,0,1,0,1,3
tarha,1,1,1,1,0,4
bundle,1,1,0,0,1,3
refuge,1,0,1,0,1,3
macleods,1,0,0,0,0,1
freedom,5,1,2,2,7,17
madame,1,1,0,0,1,3
compatible,0,0,0,0,1,1
unbreak,2,0,0,1,2,5
tongue,1,0,0,1,1,3
accapella,1,0,0,1,1,3
chulo,1,0,0,1,1,3
pistols,1,0,0,0,0,1
previously,3,1,2,0,2,8
washington,1,1,0,0,1,3
sadiko,0,0,0,0,1,1
crumbsnatchers,1,1,1,1,1,5
cocoa,1,1,1,1,0,4
couldnt,3,0,1,0,1,5
tabernacle,1,0,1,0,0,2
jing,2,0,0,2,3,7
machopolka,1,1,0,1,0,3
dolores,0,0,0,0,1,1
claras,1,1,0,1,0,3
imperial,1,2,0,0,1,4
synthesizer,1,1,0,1,1,4
afrika,1,1,0,1,1,4
inner,3,1,1,2,1,8
mohair,1,1,1,1,1,5
prophetic,1,0,1,1,0,3
north,2,1,0,2,2,7
bodyfly,0,1,0,1,0,2
jubilation,1,1,0,1,1,4
nobodys,1,0,0,0,1,2
gail,0,1,0,1,0,2
ultimo,1,0,0,0,1,2
brick,2,0,2,2,1,7
dama,0,0,0,0,1,1
rumba,1,1,0,2,2,6
svartr,1,0,0,1,0,2
cella,1,0,0,1,1,3
walter,1,0,1,1,1,4
penny,1,0,1,0,1,3
twist,4,4,1,1,2,12
beats,2,2,1,2,1,8
claraazusa,1,1,0,1,1,4
mejor,0,0,0,0,1,1
kissed,1,1,0,1,1,4
eric,1,0,1,1,1,4
pussycat,0,1,0,0,0,1
keogh,1,1,1,1,1,5
meteor,0,0,0,0,1,1
katies,1,0,1,0,1,3
talkin,4,1,1,2,2,10
motivator,1,0,1,1,0,3
allstars,1,0,1,1,1,4
fois,2,1,2,1,1,7
stay,9,8,4,9,9,39
backstage,1,1,0,1,1,4
pathways,1,0,0,1,0,2
traxx,0,0,0,1,0,1
stan,1,0,1,0,1,3
pinup,1,1,1,1,1,5
friends,8,5,2,5,6,26
coya,1,0,0,0,1,2
martin,2,1,2,1,3,9
extrao,3,0,0,1,3,7
lives,1,0,0,0,0,1
alkohol,1,1,1,1,0,4
prfrence,1,1,0,1,1,4
phunk,1,0,0,1,1,3
dynamix,0,1,0,1,0,2
captain,3,2,1,2,4,12
auprs,1,1,0,0,1,3
buddy,1,3,0,1,0,5
poco,0,0,0,0,2,2
swan,1,0,1,2,1,5
sweetest,4,2,0,0,4,10
dontchaletmecatchya,0,0,0,0,1,1
sorry,1,0,1,1,2,5
fists,1,0,0,0,0,1
rescue,2,1,0,2,1,6
downstream,1,1,0,1,1,4
void,2,1,0,2,0,5
kutcha,0,1,0,0,0,1
smack,1,0,1,0,0,2
georgia,1,0,0,0,1,2
voix,1,0,0,0,1,2
confederate,1,0,1,1,0,3
voir,1,1,0,1,1,4
pilgrim,1,0,0,0,1,2
sangre,2,0,2,1,3,8
operette,0,0,0,0,1,1
prohibido,0,0,0,1,0,1
dagens,0,0,0,1,0,1
frre,1,1,0,1,1,4
dpenaills,1,1,1,1,1,5
washout,1,0,0,1,0,2
clothes,2,0,1,2,3,8
force,2,2,0,1,2,7
dennen,1,1,0,0,1,3
histoire,2,1,1,1,2,7
canela,0,0,0,0,1,1
japanese,1,0,1,1,1,4
crave,1,0,1,0,0,2
olvido,1,0,0,0,1,2
fixin,1,1,0,0,0,2
even,1,1,0,0,1,3
fugs,1,0,0,0,0,1
tipo,0,1,0,1,0,2
wreck,1,1,1,1,0,4
orchestre,0,0,0,0,1,1
hate,7,3,3,3,6,22
panama,2,0,0,0,2,4
orchestra,1,1,0,0,1,3
while,4,3,1,1,2,11
lights,4,2,2,3,3,14
cheng,1,0,0,0,1,2
ever,12,12,7,6,16,53
mamas,1,0,0,0,1,2
million,2,1,1,2,3,9
never,39,20,15,26,32,132
meurt,1,0,1,1,0,3
nicht,4,2,2,3,4,15
active,1,0,0,1,0,2
tapes,2,1,0,0,1,4
jams,2,0,2,0,1,5
fked,1,0,0,0,0,1
jsuis,1,1,1,1,1,5
guide,1,0,0,0,1,2
omar,0,0,0,1,1,2
prolog,1,0,0,1,0,2
reste,1,1,0,1,1,4
fantastic,1,1,0,0,1,3
digitally,7,4,1,4,6,22
weevil,1,2,0,0,0,3
county,1,1,0,1,1,4
ninety,1,0,0,0,0,1
menuet,0,1,0,0,0,1
landscape,0,0,1,0,0,1
army,2,2,1,3,1,9
arms,7,2,3,2,6,20
calabar,1,1,0,1,1,4
call,19,11,6,14,14,64
calm,3,0,1,2,3,9
tell,19,8,6,13,17,63
oscar,1,0,0,0,0,1
wars,1,0,0,0,0,1
tahitian,1,1,0,1,1,4
warm,1,0,1,1,1,4
frenzy,1,1,0,1,0,3
room,7,4,7,5,9,32
rights,3,1,1,1,1,7
roof,2,1,1,2,1,7
movies,5,3,3,1,6,18
foliage,1,1,1,1,1,5
dunno,1,0,0,0,0,1
kumal,1,1,0,1,1,4
give,22,8,6,14,12,62
climax,2,1,1,2,2,8
honey,2,1,1,1,5,10
karola,1,1,1,1,1,5
frieda,0,1,0,0,1,2
unforgettable,1,0,0,1,1,3
satu,1,1,0,0,1,3
january,1,0,4,0,3,8
principe,0,1,0,1,2,4
amazing,6,6,2,4,6,24
answer,3,0,1,3,2,9
stille,1,0,0,1,1,3
quoi,1,0,0,0,1,2
quon,0,0,0,1,0,1
apartes,1,0,0,0,1,2
cadillac,2,2,1,2,2,9
besito,0,1,0,1,1,3
santos,1,1,0,0,1,3
silverstatixremix,1,0,0,1,1,3
curiosity,1,1,1,1,1,5
klarar,1,1,1,1,1,5
president,2,0,1,2,1,6
royce,1,1,0,1,1,4
annies,1,0,0,0,1,2
szallegretto,0,0,0,0,1,1
maintain,1,0,1,1,0,3
goodbye,8,5,2,0,7,22
banger,0,0,0,1,0,1
belong,5,2,2,2,4,15
madrugada,1,0,0,0,1,2
deck,3,1,1,1,2,8
fifi,0,0,0,0,1,1
lontananza,0,1,0,1,0,2
helena,2,0,0,1,2,5
mckoy,0,0,0,1,0,1
mumbo,0,1,0,0,0,1
ghastly,1,0,0,0,0,1
sickman,1,0,1,0,0,2
wickedness,1,1,1,2,1,6
before,3,2,0,0,0,5
triesteitaliana,1,0,1,0,0,2
cumayon,1,1,0,1,1,4
personal,2,2,0,1,1,6
gente,1,0,1,1,1,4
better,17,7,10,9,15,58
centrali,1,1,0,1,1,4
gents,0,0,0,0,1,1
apogee,0,1,0,1,0,2
hatesex,1,0,1,1,0,3
unemployed,1,1,0,1,0,3
isea,1,0,1,1,1,4
ernesto,1,1,0,0,1,3
grammar,1,1,0,1,1,4
meat,5,5,0,2,2,14
chuckanut,1,0,1,1,0,3
acoustic,19,13,16,12,21,81
went,1,0,0,1,0,2
side,13,8,4,6,8,39
bone,1,1,0,0,1,3
mean,5,3,2,2,3,15
doux,1,1,0,1,1,4
weightless,1,1,1,1,1,5
tannenbaum,1,0,0,1,0,2
dawg,1,1,0,1,0,3
trading,1,1,1,1,1,5
jours,2,1,1,2,2,8
doug,0,1,0,0,1,2
dawn,2,1,1,1,2,7
extract,1,0,1,1,1,4
nertz,0,1,0,0,1,2
tales,3,0,2,0,3,8
gelder,1,3,0,3,0,7
lurks,1,0,1,1,1,4
tredversfurua,1,0,0,0,0,1
patricks,2,0,0,1,2,5
satana,1,0,0,1,0,2
surprise,1,0,0,0,0,1
kanssani,1,0,1,0,1,3
grease,1,2,0,2,1,6
turning,3,1,1,2,3,10
telecommunication,0,0,0,0,1,1
revenge,0,0,1,1,0,2
negocio,0,0,0,1,0,1
maurel,0,0,0,1,0,1
greasy,1,0,0,1,1,3
shaggy,1,0,0,0,1,2
loup,1,1,1,1,1,5
manisero,1,1,0,0,1,3
cosmic,1,0,0,0,0,1
undercover,0,0,0,0,1,1
mompfreed,0,0,0,0,1,1
martillo,1,1,0,1,1,4
moving,5,2,4,5,3,19
loud,1,0,1,1,2,5
yakami,0,0,0,0,1,1
fuckin,3,0,2,2,2,9
wanikaa,1,0,0,1,0,2
longue,1,0,0,1,1,3
agradea,1,1,0,1,0,3
hoop,2,0,0,0,0,2
massif,1,1,1,1,1,5
hook,1,1,1,1,1,5
disappearing,1,1,0,1,1,4
campeones,1,0,1,0,1,3
albinonis,1,1,0,0,1,3
hood,2,1,0,0,3,6
leaders,1,0,0,1,1,3
broch,1,1,0,0,0,2
bonita,0,1,0,0,0,1
girls,15,6,8,12,13,54
interlude,4,4,4,6,8,26
girle,2,0,2,2,2,8
cccp,1,1,1,1,1,5
moisture,1,0,1,1,1,4
abril,1,0,1,1,1,4
zindegi,0,0,1,1,1,3
hadnt,1,0,1,0,1,3
eastman,1,0,0,1,0,2
pluie,1,2,0,0,2,5
begins,3,1,0,1,2,7
distance,1,2,0,1,1,5
anxiety,1,0,1,0,0,2
fairytale,2,0,1,0,3,6
consuelate,1,1,0,1,1,4
preparation,1,0,0,1,1,3
matter,6,4,3,1,5,19
solomon,0,0,0,0,1,1
louder,0,0,0,3,0,3
rosario,0,0,0,1,1,2
cavaleiro,0,1,0,0,0,1
sees,1,0,1,1,1,4
modern,2,0,0,0,1,3
mind,23,9,6,16,22,76
mine,10,6,4,5,9,34
yachts,1,0,0,1,1,3
seed,3,1,1,0,2,7
commandement,1,1,0,1,1,4
tocadiscos,1,0,0,1,1,3
seen,5,1,3,2,5,16
seem,2,1,1,1,2,7
seek,2,1,1,2,1,7
tells,1,0,0,1,0,2
expeditions,1,0,0,1,0,2
andati,1,0,0,0,1,2
ablowin,1,1,0,0,0,2
timberlake,3,1,0,0,3,7
qliphothic,1,0,1,1,0,3
gabriels,1,0,0,1,1,3
llores,0,1,0,0,0,1
sleeper,2,1,1,1,1,6
siote,1,0,1,0,0,2
memorabilia,1,0,1,1,1,4
marin,1,1,1,1,0,4
regular,1,0,0,1,0,2
mharais,0,0,0,1,0,1
nietch,1,1,0,0,1,3
shabazz,1,0,1,1,1,4
marie,1,3,0,0,1,5
olhos,0,1,0,0,0,1
maria,7,5,1,2,7,22
broadcast,2,0,0,0,2,4
alarm,3,3,1,1,4,12
definitely,1,0,0,1,0,2
scotch,2,1,0,0,0,3
urgency,1,0,0,0,2,3
planetary,1,0,0,0,0,1
hunger,1,1,1,1,1,5
rapture,1,1,0,2,1,5
visitor,1,0,1,0,0,2
chord,1,1,1,1,0,4
poison,1,0,1,0,0,2
cumberland,1,0,0,1,1,3
efharisto,1,0,0,0,1,2
sugar,3,4,0,4,3,14
unleashed,1,0,0,0,1,2
quieres,1,1,0,2,2,6
gangsta,1,1,0,1,2,5
hornys,0,0,0,1,1,2
monica,0,0,0,0,1,1
hollers,1,1,0,0,1,3
vermiss,0,0,0,0,1,1
tailors,0,1,0,1,0,2
stop,22,10,11,10,14,67
coast,2,2,1,1,2,8
watermelon,2,3,1,1,3,10
breakbeat,1,0,1,1,1,4
saturn,1,0,1,0,1,3
flowerpots,0,1,0,1,0,2
fields,4,3,2,3,3,15
disco,3,1,1,3,4,12
juoksuhautatwist,1,0,0,1,0,2
softly,4,1,2,3,3,13
playstation,1,0,1,0,0,2
fascinating,0,1,0,0,0,1
cerca,1,0,0,1,1,3
reefer,2,1,2,0,1,6
preta,1,1,0,1,0,3
phull,0,0,0,1,0,1
preto,0,0,0,1,0,1
juliet,1,0,1,0,1,3
pete,1,0,1,0,0,2
voyage,1,1,1,1,0,4
said,6,1,3,4,7,21
scrap,1,1,0,1,1,4
sais,1,0,1,1,1,4
tergum,1,1,1,1,0,4
pampa,1,0,0,0,1,2
warrior,0,1,0,0,0,1
lazy,1,1,0,0,2,4
everchanging,1,0,0,0,1,2
dressin,1,0,1,0,0,2
cousin,0,1,0,0,0,1
fiacre,1,1,0,0,1,3
compton,1,1,0,1,1,4
against,4,2,2,3,3,14
nordcore,1,0,1,1,1,4
foran,0,1,0,0,0,1
fillmore,2,2,0,2,2,8
kalyan,1,1,0,1,1,4
path,1,0,0,0,0,1
iffectz,1,0,0,1,1,3
loaded,1,1,1,1,2,6
paille,1,1,0,1,1,4
putt,0,0,0,1,0,1
interesa,1,0,1,1,1,4
asky,1,0,0,0,0,1
three,14,7,5,5,10,41
alcun,1,0,0,1,0,2
lovely,3,3,1,3,3,13
riley,0,1,0,1,0,2
threw,1,0,0,0,0,1
mhet,0,1,0,0,0,1
sunshine,4,3,2,1,4,14
allez,0,1,0,1,0,2
puedes,1,0,1,1,1,4
koti,1,1,1,1,1,5
ugli,1,0,1,1,0,3
paperman,1,1,1,1,1,5
tank,0,0,0,0,1,1
servin,0,0,0,0,1,1
tang,0,0,0,0,1,1
starts,1,0,0,0,1,2
jimprovise,1,1,1,1,1,5
ugly,1,0,0,2,0,3
near,3,1,0,1,2,7
tany,1,1,0,1,1,4
balance,1,0,1,1,1,4
nows,0,1,0,0,1,2
spawn,1,0,1,0,1,3
seven,5,2,2,2,3,14
mexico,1,0,1,1,1,4
cano,0,1,0,1,0,2
ritorna,0,0,0,0,1,1
kummiset,1,1,1,1,1,5
shame,0,0,0,1,1,2
cant,37,17,16,27,23,120
deckers,1,0,1,0,0,2
amour,1,3,1,2,2,9
grown,4,3,4,2,4,17
grnn,1,0,0,0,0,1
quand,3,1,2,2,2,10
belle,0,0,0,1,0,1
make,24,13,6,17,21,81
poulenc,0,1,0,0,1,2
belly,0,1,0,1,1,3
vegetable,1,1,1,1,1,5
grows,0,0,0,0,1,1
bells,8,5,2,6,8,29
lunes,1,0,0,0,1,2
meets,1,0,0,1,0,2
livre,0,2,0,2,1,5
ella,4,3,1,2,0,10
elle,2,1,1,3,2,9
dominions,0,0,1,0,0,1
waterfall,2,2,0,1,1,6
unicorn,1,1,1,1,1,5
jealous,1,1,0,0,1,3
ruff,1,0,0,0,1,2
firedance,0,0,0,1,0,1
transamazonia,1,0,1,1,1,4
presto,1,0,0,1,1,3
lightman,1,0,0,1,0,2
unconditionally,1,1,1,0,0,3
youre,22,12,13,10,21,78
neptune,1,1,0,1,0,3
studen,0,0,0,0,1,1
practices,0,1,0,0,0,1
roma,1,1,0,1,1,4
anchorman,1,1,0,0,1,3
vargbrodern,1,0,0,1,0,2
hacen,1,0,0,0,1,2
yours,3,0,2,3,2,10
left,10,4,3,6,4,27
just,32,22,15,20,34,123
kinky,2,0,2,1,2,7
sporting,1,1,0,1,1,4
mientras,0,0,0,0,1,1
fighters,1,1,0,0,1,3
human,8,2,7,3,2,22
acappella,1,1,0,1,0,3
angelito,1,0,0,0,1,2
bananza,0,1,0,0,1,2
sunflower,0,1,0,0,1,2
savu,1,0,1,1,1,4
royal,3,2,0,2,2,9
unlearn,0,0,1,0,0,1
autumns,1,0,0,0,0,1
harald,0,0,0,0,1,1
save,3,2,2,3,4,14
atrapados,1,0,0,1,1,3
infantil,0,1,0,1,1,3
pichleh,0,0,1,1,0,2
bboy,2,2,0,2,2,8
background,5,1,1,1,4,12
performance,6,1,2,2,6,17
chorro,1,0,0,0,1,2
dreams,10,9,2,10,11,42
saginaw,1,0,1,0,0,2
shoulder,0,2,0,0,0,2
nevermind,1,0,1,0,0,2
submission,1,0,0,1,1,3
nude,1,0,0,0,0,1
leskiidin,1,0,0,1,0,2
clementina,0,0,0,0,1,1
clavelitos,1,1,0,1,1,4
desilusin,1,0,1,1,0,3
somehow,1,0,0,0,1,2
dead,11,5,7,10,4,37
hablar,0,0,0,1,0,1
dear,2,4,0,2,3,11
visitando,0,1,0,1,0,2
carta,1,1,0,1,0,3
heiliges,0,0,0,1,0,1
tartar,0,1,0,1,0,2
arbustos,0,1,0,1,0,2
burn,5,1,0,3,2,11
boll,1,2,0,0,0,3
lolaila,0,0,0,1,0,1
protagonist,1,0,0,0,0,1
wrapup,0,1,0,1,1,3
blackest,1,0,0,0,0,1
bury,4,0,1,2,1,8
hardfloor,1,0,1,1,1,4
spanns,1,1,0,0,0,2
pugie,1,0,0,0,1,2
keros,1,0,0,0,1,2
motownphilly,0,0,0,0,1,1
valentines,1,1,0,1,1,4
beta,1,1,0,0,1,3
afternoon,2,1,1,2,1,7
luan,0,0,0,0,1,1
thelo,0,0,0,0,1,1
coins,1,0,0,0,0,1
whats,9,3,5,4,7,28
lied,2,1,0,3,2,8
castanets,1,0,0,1,1,3
down,58,29,23,24,45,179
lies,9,3,4,6,7,29
whatd,1,0,1,0,1,3
suba,0,1,0,0,0,1
chime,1,1,1,2,1,6
birdies,1,1,0,0,1,3
parade,3,3,2,2,2,12
flying,1,2,1,1,2,7
leaf,0,1,0,0,0,1
fathers,2,1,1,1,2,7
aglatma,0,1,0,0,1,2
starve,1,0,1,1,0,3
redman,0,0,0,0,1,1
fora,0,0,0,0,1,1
zeigt,1,0,1,0,1,3
failure,1,0,1,0,0,2
forr,0,1,0,1,0,2
surrender,2,2,1,1,2,8
fort,1,0,0,0,1,2
aruanda,0,1,0,0,0,1
jouer,1,1,0,1,1,4
untitled,3,1,2,2,1,9
whiskey,1,1,0,0,1,3
captin,0,1,0,0,0,1
sapphire,1,1,0,1,1,4
boomerang,2,0,2,1,0,5
daddy,3,2,1,2,3,11
underarms,1,1,0,1,1,4
zeno,1,0,1,1,1,4
classic,1,0,1,0,0,2
petit,2,1,1,2,3,9
pathaans,0,0,0,1,0,1
tarnished,1,0,1,1,1,4
fashioned,2,1,0,0,1,4
awhile,1,1,0,1,1,4
widows,1,0,1,1,0,3
unholy,1,0,1,0,0,2
shit,3,1,0,3,2,9
holla,0,0,0,1,0,1
handel,4,0,0,4,4,12
zhong,1,0,0,1,3,5
handed,0,1,0,1,0,2
digital,93,68,39,63,95,358
snowdrops,1,0,1,0,1,3
holly,1,1,0,0,1,3
fuschnick,1,1,1,1,0,4
tamale,1,1,1,1,1,5
dies,2,1,1,0,2,6
provisoirement,1,0,0,0,0,1
dieu,1,1,0,1,1,4
nykii,1,0,0,0,0,1
fell,2,0,1,0,2,5
lafayettes,0,0,3,0,3,6
geroi,0,0,0,1,1,2
barracuda,1,0,0,0,1,2
died,1,0,0,0,1,2
jones,4,2,1,1,3,11
noviembre,0,0,0,1,0,1
outskirts,2,1,1,1,1,6
clubmix,1,1,0,1,1,4
shaskeen,1,0,0,0,0,1
teeth,2,1,2,1,0,6
poussire,1,0,1,1,1,4
proletariat,1,1,1,1,0,4
exspecto,0,0,0,1,0,1
skit,3,6,1,3,4,17
telefon,1,1,1,1,1,5
menoo,1,1,1,1,1,5
soulo,0,0,0,0,1,1
mile,3,1,2,0,1,7
skin,5,1,1,1,4,12
mill,2,1,1,1,0,5
milk,1,1,0,0,1,3
suicide,2,0,1,1,1,5
praises,0,1,0,0,0,1
gheera,0,0,1,1,1,3
verrckt,1,0,0,1,1,3
torna,1,1,1,0,1,4
father,5,3,2,2,1,13
hurtin,1,0,0,0,1,2
lotus,1,1,1,1,1,5
finally,3,2,2,1,3,11
string,2,3,0,3,1,9
jezebel,1,0,1,1,1,4
lynch,1,1,0,1,0,3
anne,2,0,1,0,1,4
jhatt,0,0,0,1,0,1
somos,1,0,0,1,1,3
prvni,1,1,1,0,1,4
round,12,9,1,9,9,40
nomadbrothers,0,1,0,0,1,2
work,3,3,0,4,3,13
shava,0,0,0,1,0,1
camelot,1,1,0,1,0,3
etiinen,1,0,0,0,1,2
rafaniello,0,0,1,1,0,2
fistful,1,0,0,1,0,2
heres,0,0,0,1,1,2
filles,1,0,0,1,1,3
kommissar,1,1,1,1,1,5
guardian,2,2,1,2,2,9
ridin,1,1,0,1,1,4
french,3,3,2,4,4,16
jazze,1,0,0,0,1,2
kpenhaminassa,1,1,0,0,1,3
wait,8,6,4,4,8,30
zombie,1,0,1,1,1,4
spencertracey,1,1,1,0,1,4
shift,0,0,0,1,0,1
mortii,1,0,0,1,0,2
monades,1,1,0,1,1,4
teenage,3,1,0,1,0,5
consolation,2,0,0,0,1,3
roter,1,1,0,1,1,4
everybody,4,2,2,3,3,14
kopla,1,1,1,1,1,5
layne,2,1,0,0,0,3
sake,3,0,1,1,1,6
dude,1,1,0,1,0,3
javais,1,1,0,0,1,3
france,5,2,1,3,4,15
terrarium,0,0,0,1,0,1
thru,1,0,0,0,1,2
vous,3,2,0,1,2,8
velem,1,0,0,1,1,3
freestyle,2,1,1,2,1,7
novio,0,0,0,0,2,2
americano,1,0,0,0,0,1
downtown,3,2,2,1,3,11
ferrous,0,0,0,1,1,2
olive,1,0,1,1,1,4
pollys,1,1,0,1,1,4
baltechs,1,1,0,0,0,2
labrie,1,1,0,1,0,3
abbeville,1,0,0,0,0,1
spoonie,0,1,0,1,1,3
bongsession,1,0,1,0,0,2
soul,24,18,8,13,12,75
sous,2,3,0,1,4,10
sour,1,1,0,1,0,3
sitiera,0,0,0,0,1,1
djungelstadt,0,0,0,1,0,1
making,0,0,0,1,0,1
hiroshima,2,0,0,2,0,4
merzwaltz,1,0,1,1,0,3
crazy,10,8,5,3,11,37
funhouse,1,0,1,0,0,2
fuck,1,0,0,1,2,4
manuels,1,1,0,1,1,4
sample,6,5,1,5,6,23
psihi,0,0,0,0,1,1
acapulco,1,1,0,0,1,3
craze,1,1,1,1,0,4
pink,1,0,1,1,0,3
oslo,1,0,0,0,0,1
ping,1,0,0,0,1,2
pind,0,0,0,0,1,1
till,4,2,3,5,5,19
sunday,8,3,6,5,6,28
radioalbum,1,1,0,1,1,4
pure,2,1,2,2,1,8
maestro,2,1,2,2,2,9
persuasion,1,1,0,0,1,3
puro,0,1,0,0,1,2
loaves,1,1,0,0,1,3
designer,1,0,1,1,0,3
huitquarts,0,0,0,1,0,1
punjabian,1,1,1,1,1,5
hombre,1,0,0,0,1,2
guys,4,1,2,1,4,12
grow,5,3,0,3,4,15
neck,3,1,0,2,1,7
johnson,0,0,0,1,1,2
maybe,3,3,1,1,2,10
punnany,1,0,0,0,0,1
cantabile,1,1,0,1,0,3
jail,2,1,0,0,1,4
slangen,1,0,1,0,0,2
african,0,1,0,0,0,1
thorns,1,0,1,0,0,2
tall,1,0,0,0,0,1
talk,16,8,8,11,13,56
bozack,0,0,0,1,0,1
gatemouth,1,1,0,0,1,3
shoes,2,1,2,1,2,8
josephine,2,2,2,2,2,10
immer,1,1,1,1,0,4
getunow,1,1,0,1,1,4
shake,6,4,2,6,6,24
irene,1,0,0,0,0,1
texan,1,1,0,0,0,2
police,2,1,0,0,1,4
thank,7,3,4,4,4,22
mais,1,1,1,1,1,5
thang,3,2,2,4,3,14
buckys,1,1,0,1,1,4
akhan,0,0,0,0,1,1
ours,1,1,0,0,1,3
main,6,4,3,5,6,24
texas,2,1,0,1,0,4
within,3,0,2,0,0,5
killer,5,2,1,2,3,13
minuet,2,1,0,2,2,7
mortuorum,0,0,0,1,0,1
safari,1,1,0,1,1,4
sisyphe,0,0,1,1,0,2
killed,5,3,3,3,4,18
teller,1,0,0,0,1,2
buntar,1,0,0,1,0,2
feverish,1,1,1,1,1,5
arrows,1,1,0,1,0,3
careless,2,2,0,1,2,7
rock,39,14,18,19,31,121
hammerklavier,1,0,0,1,1,3
bombo,0,0,0,0,1,1
vogue,1,0,0,0,1,2
odysseymovement,1,0,0,1,1,3
abnormal,1,1,1,0,1,4
vagabond,1,2,0,1,1,5
manifesto,1,0,1,0,1,3
preaching,1,1,0,1,1,4
giro,2,2,2,2,2,10
girl,42,17,26,29,40,154
morning,18,12,4,8,16,58
canada,2,1,0,2,1,6
living,5,2,3,3,4,17
eyolf,1,0,0,0,0,1
plaisir,1,0,1,1,1,4
jackson,0,0,0,0,1,1
multiplayer,0,0,0,1,0,1
resilience,1,0,0,1,1,3
firewater,1,0,1,0,0,2
miles,4,2,3,1,4,14
nudez,0,0,0,0,1,1
haydn,0,1,0,0,1,2
assurance,1,0,0,0,1,2
monster,1,1,0,1,1,4
bodhrn,1,0,0,0,0,1
california,3,1,2,1,2,9
amigos,2,0,1,0,2,5
awayhere,1,1,1,1,1,5
watts,1,0,0,1,1,3
sabor,1,3,1,2,1,8
carnival,1,3,0,1,2,7
ministry,1,1,0,1,0,3
worrying,1,0,0,0,1,2
thing,13,11,6,10,14,54
funky,3,2,3,4,2,14
thine,3,1,0,2,3,9
desultory,1,0,0,1,1,3
think,13,7,3,6,14,43
first,15,6,6,13,15,55
journeyiv,1,1,0,0,1,3
lascia,1,0,0,0,1,2
americana,2,0,1,1,2,6
nicpig,0,0,0,1,0,1
lone,1,1,0,1,1,4
mlodie,1,1,0,0,1,3
fast,2,3,0,1,1,7
carry,1,1,1,1,1,5
sounds,3,3,2,4,2,14
little,48,32,16,26,40,162
chanson,1,1,0,1,6,9
slept,0,1,0,0,0,1
laquelle,1,1,0,1,1,4
anyone,1,1,0,1,1,4
plains,1,0,0,0,1,2
fiery,1,0,0,1,0,2
jeannette,0,1,0,0,1,2
bruk,0,0,0,0,1,1
cetait,1,1,0,1,1,4
mermaid,1,0,1,0,0,2
bloodshed,1,0,0,0,0,1
eyes,22,11,13,15,17,78
moscow,1,0,0,0,0,1
marrakech,1,0,0,1,1,3
buts,1,1,0,1,0,3
harbour,0,1,0,0,0,1
eyed,1,1,0,0,2,4
butt,1,1,1,1,1,5
embraceable,1,1,0,1,1,4
cracks,1,0,1,0,0,2
sailing,1,0,2,1,1,5
gotta,11,2,6,8,8,35
cabiria,1,1,0,0,0,2
lappart,1,1,1,1,1,5
marcharte,0,0,0,1,1,2
loiseau,0,1,0,0,0,1
were,15,9,6,7,12,49
burbs,1,0,1,1,0,3
cuir,1,0,1,1,1,4
lullaby,10,6,5,5,8,34
marijuana,1,0,1,0,1,3
voices,5,4,1,3,4,17
dash,0,0,0,1,0,1
winding,1,0,1,1,1,4
lamb,3,0,0,0,1,4
kevin,1,0,1,0,0,2
isolate,1,0,1,0,0,2
brillantes,1,1,1,1,1,5
squad,2,1,1,1,2,7
bailey,1,1,1,1,0,4
valse,5,6,0,2,6,19
ultimate,0,1,0,1,1,3
blackfoot,1,0,1,1,1,4
skinned,0,1,0,0,0,1
pain,6,3,1,3,5,18
theatre,3,2,0,3,2,10
track,31,12,10,19,21,93
zigzag,1,1,0,1,1,4
insanity,0,0,1,1,0,2
rehearsal,1,1,0,0,1,3
paix,1,1,1,0,1,4
barrage,0,1,1,0,0,2
skinner,0,1,0,1,0,2
nadine,1,0,1,0,0,2
pair,1,1,0,0,0,2
tracy,2,1,0,1,1,5
queens,0,0,0,0,1,1
pequeo,1,1,0,1,0,3
surprising,1,0,0,0,0,1
lenny,1,0,1,1,0,3
gracefully,1,0,0,0,0,1
fille,1,1,1,1,1,5
voodoo,3,1,0,0,1,5
nlida,0,1,0,1,0,2
shop,1,0,1,1,1,4
shot,2,1,1,1,3,8
shou,1,0,0,0,3,4
show,14,6,7,8,10,45
olvidar,0,0,0,0,1,1
estoy,1,0,0,1,2,4
corney,1,1,0,0,0,2
campana,0,1,0,0,0,1
corner,4,5,2,1,5,17
campane,1,1,0,0,1,3
lieder,1,1,1,1,1,5
stormy,1,1,0,0,1,3
dich,2,0,1,2,3,8
behind,0,0,0,1,0,1
black,16,10,4,12,9,51
ranking,1,0,0,1,1,3
poquitito,0,0,0,0,1,1
munk,1,1,1,1,1,5
otthat,0,0,0,0,1,1
stomp,1,1,1,1,1,5
hippa,1,0,0,1,0,2
irapijerkifly,0,0,0,0,1,1
vitrier,1,1,0,0,1,3
nouveau,0,0,0,1,0,1
trumansburg,1,1,0,1,1,4
probka,1,1,0,0,1,3
spter,1,1,0,1,1,4
medias,1,0,0,0,1,2
stupid,1,0,1,0,0,2
mergences,1,1,0,0,0,2
flamingos,0,1,0,1,0,2
bachata,1,0,0,1,1,3
sittin,2,2,0,0,1,5
boleyn,1,0,0,0,0,1
oven,1,1,1,1,1,5
float,1,0,0,0,1,2
sean,2,2,1,3,1,9
revois,1,1,0,0,1,3
wonder,3,2,1,1,4,11
arbre,1,1,0,0,1,3
twosided,1,1,1,1,0,4
distantes,2,2,0,2,2,8
apisti,1,0,0,0,1,2
vanne,0,0,0,1,0,1
enough,8,1,2,2,6,19
diamonds,1,2,0,1,1,5
across,2,1,1,1,1,6
timmy,1,2,0,2,0,5
killing,5,1,1,4,3,14
muchachas,0,1,0,0,0,1
chacha,0,0,0,1,1,2
nougaro,1,1,1,1,1,5
nocturne,1,1,0,0,1,3
according,0,0,0,1,0,1
nonpa,1,0,0,0,0,1
baile,1,0,0,0,1,2
tour,6,3,1,5,5,20
tous,2,1,0,2,2,7
tout,1,1,0,0,1,3
guardians,1,0,1,0,0,2
among,0,1,0,2,1,4
miattad,1,0,1,1,1,4
scherzo,1,0,0,1,1,3
garota,1,1,0,0,1,3
sailin,1,1,0,0,0,2
kathleens,1,1,0,1,0,3
hanuriin,1,0,0,1,1,3
sensible,0,0,0,0,1,1
unusual,1,1,0,1,1,4
tercer,1,0,0,0,1,2
underworld,1,0,0,1,0,2
tramp,1,1,0,0,1,3
djessy,0,1,0,1,1,3
mari,2,1,0,1,2,6
mark,3,2,1,2,2,10
arte,1,0,0,1,1,3
mars,3,0,0,2,2,7
mary,11,3,2,2,6,24
pathfinders,1,0,0,1,0,2
graveyard,1,0,1,1,1,4
festante,1,0,0,0,1,2
puerile,1,0,1,1,1,4
wake,10,1,8,4,8,31
declaration,1,0,0,0,0,1
overdose,1,0,0,0,0,1
hardcore,0,0,0,1,0,1
ascolta,1,0,0,0,1,2
those,5,3,2,2,4,16
wyomin,1,0,0,1,0,2
sound,12,4,7,9,10,42
disconnected,1,1,1,1,1,5
saboreando,0,0,0,1,0,1
ongoing,1,0,1,0,0,2
coco,2,0,0,2,2,6
cock,1,0,0,0,0,1
coffee,0,1,0,0,0,1
marcel,1,0,1,1,1,4
sleeping,4,1,3,3,3,14
strain,1,1,0,1,0,3
dangerously,1,1,0,0,1,3
cariocas,1,1,0,0,1,3
pamella,1,1,1,1,1,5
everyday,5,3,3,3,4,18
bags,0,0,0,2,2,4
different,2,3,0,1,1,7
harsh,1,0,1,1,0,3
doctor,3,2,2,2,2,11
rappst,1,0,0,1,1,3
same,12,10,7,9,13,51
waterliked,0,0,0,0,1,1
heartbreak,1,0,1,1,1,4
speech,1,1,0,1,1,4
elementro,0,0,0,1,0,1
extended,10,7,6,11,11,45
pega,1,1,0,0,1,3
running,5,2,2,2,6,17
improv,0,1,0,1,1,3
nostradamus,0,0,0,0,1,1
totally,1,0,1,0,1,3
nevadas,1,0,0,0,1,2
markus,1,1,1,1,1,5
maracaibo,0,1,0,0,1,2
spoonful,1,1,0,1,0,3
ryman,1,0,0,0,1,2
bottle,2,1,1,1,1,6
money,9,4,4,5,6,28
nordfjorloftet,1,0,0,1,0,2
voiliers,1,1,1,1,1,5
flavor,0,0,0,0,1,1
alimony,0,0,0,0,1,1
bowie,1,0,0,1,1,3
pila,0,0,1,0,1,2
tren,0,0,0,1,1,2
pile,1,1,0,0,2,4
lahnstein,1,0,0,0,0,1
meteorito,0,0,0,0,1,1
gris,2,0,0,2,2,6
docks,1,1,0,1,0,3
ricerca,1,1,0,1,1,4
dodos,0,1,0,0,0,1
forge,1,0,0,0,0,1
grid,1,0,1,0,0,2
railroad,1,0,1,1,0,3
implicate,1,1,0,1,1,4
grim,3,0,3,3,0,9
grin,1,0,0,0,0,1
fondling,1,0,0,1,1,3
perdus,1,1,0,0,1,3
christina,3,2,1,0,1,7
server,1,1,0,1,0,3
chamber,2,0,0,2,0,4
thighs,1,1,1,0,1,4
hallelujah,1,0,1,1,1,4
served,1,0,1,0,0,2
remasteris,1,2,1,2,1,7
robbers,1,0,0,1,0,2
baixinho,0,1,0,0,0,1
kpenhamn,1,1,0,0,1,3
doll,4,4,2,3,4,17
naal,0,0,0,1,0,1
felguk,1,0,0,0,1,2
cadenaslive,0,0,0,0,1,1
spasa,0,0,0,0,1,1
choir,1,1,1,0,0,3
bones,3,1,1,1,3,9
ellis,0,1,0,1,0,2
qiang,0,0,0,0,1,1
moderato,1,0,1,1,0,3
oute,1,0,0,0,1,2
linoleum,1,0,0,0,1,2
knife,2,1,0,0,1,4
brigid,0,0,0,0,1,1
seconds,1,0,1,0,1,3
jennings,1,1,0,0,1,3
arts,1,1,0,0,1,3
broken,8,3,4,4,5,24
secondo,0,0,0,0,1,1
descontrol,0,0,0,0,1,1
drums,1,1,1,1,1,5
unissued,1,0,1,0,1,3
soorma,0,0,0,1,0,1
island,1,1,0,2,1,5
violence,1,1,0,1,0,3
doiseau,1,1,0,0,1,3
youve,3,2,1,2,2,10
mixed,1,1,0,0,1,3
road,12,5,6,7,11,41
honky,1,1,0,1,1,4
lands,1,1,0,1,1,4
fertile,1,0,1,0,1,3
whites,1,0,0,1,0,2
whiter,2,1,0,2,2,7
seora,0,1,0,0,0,1
crossfire,2,0,1,1,1,5
empress,0,0,0,1,0,1
fresse,0,0,0,1,0,1
strip,1,0,0,1,1,3
prendsmoi,0,0,1,0,0,1
versin,1,1,0,0,1,3
jerusalem,1,1,0,0,1,3
wildfire,1,1,0,0,0,2
brute,1,0,0,0,0,1
fates,1,0,1,0,1,3
lions,1,0,1,0,1,3
trey,0,0,0,0,1,1
emeralds,1,1,0,1,1,4
delilah,1,1,0,0,1,3
pulmn,1,0,1,0,1,3
risin,1,0,1,0,0,2
strikes,3,1,1,1,1,7
sophisticated,0,1,0,1,0,2
laina,0,0,0,1,0,1
gora,0,0,0,2,2,4
mayerling,1,1,0,1,1,4
romantic,3,0,0,1,0,4
elmss,1,0,1,1,1,4
benton,1,0,1,1,0,3
miyela,1,1,0,1,1,4
hispaniola,0,1,0,0,0,1
meng,0,0,0,0,1,1
manuel,1,1,0,0,0,2
conqueror,1,0,1,1,0,3
sandpolskan,0,0,0,1,0,1
affection,0,1,0,0,1,2
piroschka,1,0,0,1,1,3
celestial,1,0,1,1,1,4
carpe,1,0,1,1,0,3
groovin,3,2,0,2,2,9
deep,12,4,5,5,14,40
fellow,1,1,0,1,0,3
imagination,1,1,0,2,2,6
gumby,1,1,1,1,1,5
outtake,2,2,1,2,2,9
hound,2,2,0,1,1,6
film,1,1,0,0,0,2
again,36,14,14,17,29,110
pottajenkka,1,1,1,1,1,5
suitehearts,1,0,1,0,1,3
field,1,0,1,0,0,2
astronaut,1,1,0,1,0,3
moizamicy,1,0,0,0,0,1
acoustique,1,0,1,1,1,4
shelter,1,2,1,2,1,7
larock,0,0,0,1,0,1
abscondence,0,0,0,0,1,1
corcovado,1,2,1,1,2,7
keepin,0,0,0,1,0,1
chris,1,0,2,2,0,5
diabla,1,0,0,0,1,2
remaster,90,68,38,62,92,350
diable,1,1,1,0,1,4
remote,1,0,1,0,1,3
jlai,1,0,0,0,0,1
gigantor,1,0,1,0,1,3
alright,10,4,8,4,9,35
nunca,0,0,0,1,1,2
represent,1,0,0,0,0,1
liar,2,0,0,1,0,3
forget,4,3,1,3,4,15
forbidden,1,0,1,1,1,4
tappartiens,0,1,0,0,1,2
yhteinen,1,1,1,1,1,5
wexford,1,0,0,0,0,1
talks,1,0,1,1,1,4
liao,0,0,0,0,1,1
children,4,1,3,2,4,14
shattered,2,1,2,1,1,7
anglais,1,1,0,0,1,3
imma,1,0,0,0,1,2
alberts,1,1,0,1,1,4
enkeli,1,0,0,0,0,1
estrofas,1,0,0,0,0,1
crimson,2,1,0,1,1,5
mornin,1,1,0,2,2,6
sitting,2,1,0,0,1,4
billie,1,1,0,1,1,4
einmal,2,0,1,1,2,6
fall,10,4,4,5,9,32
subterranean,1,1,1,1,1,5
difference,3,1,0,1,2,7
bestio,1,1,1,1,0,4
alcazar,0,1,0,1,0,2
lumier,0,0,0,1,0,1
hollerin,1,0,0,0,0,1
alma,4,2,0,3,4,13
mothers,3,1,4,2,3,13
beeatch,0,0,0,1,0,1
gang,0,0,0,0,1,1
explorador,1,0,0,0,1,2
zero,3,2,1,3,3,12
titles,2,1,0,0,1,4
lawyer,1,1,0,0,0,2
incide,1,0,0,0,0,1
creatures,1,0,0,0,1,2
timxtreme,1,0,1,1,1,4
stood,3,3,1,2,3,12
dcor,1,1,1,1,1,5
tribute,2,1,1,2,1,7
everlasting,1,1,1,0,1,4
dias,0,0,0,1,0,1
movement,5,0,1,3,3,12
christe,1,0,1,1,1,4
mule,2,2,1,1,1,7
ranger,1,0,0,1,0,2
beacon,2,2,0,2,2,8
simon,2,1,2,1,2,8
vals,1,1,1,1,2,6
qutate,1,0,0,0,1,2
sabras,0,0,0,1,1,2
search,2,2,1,2,2,9
jackie,1,1,0,0,0,2
noites,2,2,0,0,2,6
paid,1,0,0,0,1,2
conts,1,0,1,0,1,3
misery,1,1,0,0,0,2
felicidade,1,1,0,1,0,3
dansende,0,1,0,0,0,1
minutos,1,0,0,1,0,2
slaughtergod,1,0,1,0,0,2
caravan,0,0,1,0,0,1
mastering,0,1,0,1,0,2
africa,1,0,0,0,1,2
emptied,0,1,0,1,1,3
suits,1,1,0,1,0,3
nothings,2,2,2,2,2,10
astrodome,0,0,0,0,1,1
destination,1,0,1,1,1,4
laivamatka,1,1,0,1,1,4
apertura,1,1,0,1,1,4
neverending,2,1,1,2,1,7
chiamano,0,0,0,0,1,1
diamond,4,1,3,2,4,14
asheville,1,0,0,0,0,1
lemons,1,0,1,0,0,2
caderona,0,1,0,0,0,1
komm,1,1,0,1,1,4
karaoke,0,0,0,1,1,2
town,22,13,9,13,17,74
guarda,1,1,0,1,1,4
plaintes,1,0,0,1,1,3
hour,4,2,1,4,2,13
voyagers,0,1,0,1,0,2
bascombe,1,0,0,1,1,3
fefita,1,1,0,1,1,4
nupcial,1,0,1,0,1,3
numbers,2,1,1,1,1,6
glorieux,0,2,0,3,0,5
robinson,1,1,0,0,0,2
mackab,1,0,0,1,1,3
needs,1,1,1,1,0,4
needy,0,1,0,0,0,1
comfort,1,0,1,0,1,3
tysikasvuinen,1,0,0,0,1,2
mditations,0,1,0,1,0,2
sacred,1,0,0,0,0,1
ensemble,0,1,0,0,1,2
rastafari,1,1,0,1,1,4
viene,1,0,1,1,1,4
petite,2,2,2,2,1,9
advice,2,0,1,1,2,6
viens,0,1,0,1,2,4
petits,2,2,1,2,2,9
blood,16,4,5,8,8,41
coming,7,4,2,5,4,22
kaufen,1,1,0,1,1,4
trois,2,0,1,2,2,7
orchard,1,1,0,1,1,4
dragon,2,0,0,1,0,3
coal,1,1,0,0,0,2
turnpike,1,0,0,0,0,1
pleasure,1,1,1,2,1,6
playing,3,2,0,1,2,8
serenade,3,3,1,2,3,12
infant,1,1,0,1,1,4
shubas,1,1,1,0,1,4
radar,1,0,0,0,1,2
through,11,9,4,10,11,45
suffer,1,0,0,0,0,1
winger,1,0,1,1,1,4
balon,1,0,0,1,1,3
baat,1,1,1,1,1,5
late,3,0,5,2,2,12
pena,1,1,0,1,2,5
vajda,0,0,0,1,1,2
ravnec,1,1,0,0,1,3
remmus,1,1,1,0,1,4
ralphs,1,1,0,1,0,3
excepcion,1,0,1,1,1,4
hecha,1,0,0,0,1,2
walls,4,2,2,4,4,16
ralphi,0,0,0,1,1,2
goor,1,1,1,1,1,5
complain,1,1,0,1,1,4
mystery,1,0,1,1,1,4
compter,1,1,1,1,1,5
rant,1,0,0,1,1,3
empiece,1,0,1,1,1,4
malone,1,1,0,1,0,3
ashes,2,0,1,1,1,5
someone,6,3,2,3,7,21
learing,1,0,0,0,1,2
mbta,1,0,0,0,1,2
pulecenella,0,0,0,0,1,1
monsoon,1,0,0,0,1,2
harboring,1,0,0,0,0,1
towin,1,1,1,0,0,3
everyone,3,0,1,1,1,6
chopper,1,0,0,1,1,3
house,23,11,13,10,22,79
fish,1,0,1,1,0,3
hard,12,7,6,7,6,38
connect,1,1,0,1,1,4
portland,1,1,1,1,1,5
insurance,1,1,0,1,1,4
mystre,0,1,0,1,0,2
lovers,5,5,1,2,5,18
perro,1,0,1,1,1,4
print,2,2,2,2,2,10
pehle,0,0,0,1,0,1
bully,2,0,2,0,2,6
caravane,1,0,1,1,1,4
cielito,0,0,0,0,1,1
disposition,2,0,1,2,1,6
beginning,4,2,2,2,3,13
bendiga,0,1,0,1,1,3
finland,1,1,0,1,1,4
wither,0,0,1,0,1,2
rainforest,1,1,0,1,1,4
dont,97,51,37,53,83,321
nach,0,0,0,2,0,2
valentine,0,1,0,0,0,1
entanglement,1,1,1,1,0,4
done,5,4,1,2,4,16
cade,1,0,0,1,0,2
pudor,1,0,0,0,1,2
razor,1,0,1,0,1,3
least,1,0,0,0,1,2
mami,0,1,0,0,0,1
paint,1,1,1,1,1,5
larrach,1,0,0,0,0,1
jetta,1,0,1,1,1,4
mama,6,4,1,3,2,16
ordure,1,1,1,1,1,5
para,4,2,1,3,5,15
etsi,1,0,0,1,1,3
park,3,1,1,2,2,9
sensation,1,0,1,0,1,3
part,26,13,16,21,20,96
lhomme,1,1,0,1,2,5
believe,11,6,4,6,12,39
supplice,1,0,0,1,1,3
mclaughlin,0,1,0,1,1,3
youth,4,1,1,3,3,12
vierge,0,1,0,1,0,2
ubik,1,0,1,1,1,4
liberabo,0,0,0,0,1,1
outta,2,1,2,0,2,7
highspeed,1,0,0,1,1,3
fading,1,0,0,0,1,2
backseat,1,1,0,0,0,2
mountain,5,1,0,3,4,13
madazulu,1,1,0,1,1,4
dancing,9,2,6,5,8,30
flaming,1,0,0,0,1,2
build,1,1,0,0,1,3
mose,0,0,0,1,1,2
serene,0,1,0,0,0,1
serena,1,0,0,0,0,1
flute,2,3,1,2,2,10
essa,0,1,0,0,0,1
moss,1,1,1,1,1,5
gyere,1,0,0,1,1,3
reflections,1,1,0,1,1,4
tellurique,1,0,0,1,0,2
sector,1,1,1,1,1,5
thomas,1,1,0,1,1,4
guantanamera,1,1,0,0,1,3
sparrow,2,1,2,1,2,8
wailing,1,1,1,1,0,4
posterchild,1,0,1,1,1,4
carne,2,1,0,1,1,5
fina,1,1,0,1,1,4
headlines,1,0,0,0,1,2
auditorio,1,0,0,0,1,2
fine,4,3,3,4,4,18
find,8,7,0,8,7,30
negura,1,0,0,1,0,2
frisch,1,1,1,1,1,5
chimes,0,0,0,1,1,2
giant,0,1,0,1,1,3
tocame,0,0,0,0,1,1
legionnaire,1,1,0,0,1,3
nervous,2,0,2,2,2,8
poppin,1,0,0,0,1,2
matesi,1,0,0,1,1,3
unhappy,1,0,0,0,0,1
eleison,1,0,1,1,1,4
weve,3,3,1,3,3,13
mein,3,2,0,2,4,11
rest,2,3,1,3,2,11
suzie,1,0,0,1,1,3
contagious,2,0,1,2,0,5
lachen,1,1,0,1,1,4
common,1,2,1,2,2,8
gospel,2,0,0,1,2,5
severing,1,0,0,1,1,3
sessionsaol,1,0,1,0,1,3
devils,4,4,2,4,3,17
vine,1,1,0,2,1,5
devilz,1,0,0,0,0,1
tender,1,1,0,0,0,2
fruta,0,1,0,1,0,2
fang,1,0,0,2,2,5
pennoe,1,0,0,1,0,2
please,16,7,7,7,12,49
riccardoamelia,1,0,0,1,0,2
powerhouse,1,0,0,0,1,2
fans,1,0,1,1,1,4
burned,1,0,0,0,0,1
champagne,3,1,1,1,2,8
rosie,1,1,0,0,1,3
gulabi,0,0,0,1,0,1
nashville,1,0,1,1,1,4
mailbox,1,0,0,0,1,2
fuckaz,0,0,0,1,0,1
pepsi,0,1,0,1,0,2
marilyn,1,0,1,1,1,4
gnosis,0,0,0,1,0,1
restaurant,1,1,0,0,1,3
magdalaine,1,0,1,1,1,4
foreign,1,0,0,0,0,1
afar,1,0,0,0,1,2
baltimore,1,0,0,0,1,2
cakes,1,1,0,0,1,3
consume,1,0,1,0,0,2
point,1,0,1,0,1,3
simple,7,2,1,4,5,19
keypremiere,1,1,0,1,1,4
andar,1,0,0,0,1,2
gypsy,1,2,0,0,2,5
dances,2,1,1,0,1,5
dancer,3,3,0,3,2,11
poing,1,0,1,1,1,4
nakon,1,0,0,0,0,1
ertegun,1,1,0,0,1,3
expensive,1,0,1,1,1,4
elektro,1,0,0,1,1,3
raise,2,1,0,0,1,4
glocks,0,0,0,0,1,1
create,1,0,0,0,1,2
secret,7,3,3,5,6,24
ireland,0,1,0,0,0,1
sudenkorento,1,0,0,1,1,3
meeting,1,0,0,1,1,3
slips,2,0,1,0,1,4
addison,1,0,1,1,1,4
understand,3,1,1,1,3,9
pueblito,1,1,0,1,1,4
ignis,1,0,1,1,0,3
solid,1,0,1,1,1,4
bill,2,1,2,2,1,8
eclipsed,1,0,0,0,1,2
billies,1,1,1,0,1,4
skiff,1,1,0,1,0,3
deckard,1,0,1,1,0,3
escapin,0,1,0,1,0,2
portugal,0,0,0,1,0,1
century,3,0,4,1,1,9
wollen,1,0,1,1,1,4
jake,1,0,0,1,1,3
trafiko,0,0,0,1,0,1
xtra,0,0,0,1,0,1
recht,1,0,0,0,0,1
remedio,1,1,0,1,1,4
selfportrait,0,1,0,0,0,1
janus,1,0,0,0,1,2
butcher,1,1,0,0,0,2
comprimise,1,1,1,1,1,5
basta,0,1,0,0,1,2
achek,0,0,1,1,1,3
strips,1,0,1,0,0,2
keys,2,1,0,2,1,6
yesterday,0,0,0,1,0,1
husbands,1,1,1,1,1,5
moment,6,4,3,2,3,18
tash,1,0,0,2,1,4
camron,0,0,0,1,0,1
finesse,0,1,0,0,1,2
entre,3,0,1,2,3,9
werewolf,1,0,0,1,1,3
spent,1,0,1,0,0,2
phillippe,1,0,0,1,1,3
sajana,0,1,0,1,0,2
chemistry,1,0,1,0,0,2
spend,2,1,1,1,2,7
nols,1,0,0,1,1,3
liverpoolin,1,1,1,1,1,5
guang,0,0,0,0,2,2
shape,1,0,0,0,1,2
atomic,1,0,1,1,1,4
cancin,2,2,1,2,2,9
terslintu,0,0,0,0,1,1
alternative,1,0,0,0,1,2
pranafestation,0,0,0,1,0,1
nuestro,1,0,0,0,1,2
letting,2,0,1,0,0,3
hated,2,1,0,1,0,4
alternate,2,2,2,1,4,11
calibre,0,1,0,1,1,3
easter,0,2,0,0,0,2
laughed,1,0,0,0,0,1
judgement,2,0,1,1,1,5
matters,1,0,1,1,1,4
vapour,0,0,0,1,0,1
knock,2,1,0,0,0,3
calypso,1,0,0,1,1,3
feriado,1,0,0,0,1,2
shudder,1,0,1,1,1,4
bamboo,1,1,0,1,0,3
foolish,1,1,0,2,2,6
limportant,1,1,0,1,1,4
vergeht,1,1,1,1,1,5
collectors,1,1,0,0,0,2
triceratops,1,1,0,1,0,3
magnificent,1,0,1,1,1,4
barracos,0,1,0,1,0,2
bach,2,1,1,0,1,5
baci,1,0,0,0,1,2
strongest,1,1,1,1,1,5
cicada,1,0,1,0,1,3
mirror,3,0,2,1,1,7
lightning,2,0,1,2,1,6
rockdrive,1,0,1,1,1,4
jewelry,1,1,1,1,1,5
energia,0,1,0,1,0,2
hoochie,1,1,1,1,1,5
lark,1,0,1,1,1,4
acte,1,0,0,0,1,2
larh,0,0,0,1,0,1
laughing,1,1,1,0,0,3
sangha,2,2,0,2,2,8
bewitched,1,0,0,0,1,2
kudian,0,0,0,0,2,2
birdsongs,1,1,0,1,0,3
valrie,0,1,0,1,0,2
tripping,1,1,1,0,1,4
milkman,0,1,0,0,0,1
vaisakhi,0,0,1,1,0,2
juste,2,2,2,1,2,9
goody,1,3,1,1,1,7
morro,0,2,0,1,1,4
drama,2,1,2,1,0,6
ounce,1,0,0,0,1,2
waltz,4,2,2,2,4,14
jimmy,2,1,0,0,1,4
aliens,1,0,0,0,0,1
framed,1,1,0,0,1,3
taiteilijan,1,0,0,0,1,2
fallin,0,1,0,1,1,3
sunshower,1,1,0,1,0,3
lesson,2,0,1,0,0,3
witchcraft,1,0,0,1,1,3
sengraisse,0,1,0,0,1,2
moulin,1,3,0,1,1,6
infected,2,0,2,1,2,7
forward,1,1,0,1,1,4
bored,1,0,0,0,0,1
skopska,0,0,0,1,0,1
getto,0,0,0,1,0,1
pimpin,2,0,0,1,1,4
tirols,0,1,0,1,1,3
murphy,0,1,1,0,1,3
boys,9,4,5,11,8,37
rcit,0,1,0,0,1,2
hopes,1,1,1,0,0,3
aviatic,1,1,0,0,1,3
groovy,1,1,1,1,1,5
laziest,1,1,0,0,1,3
planet,3,1,1,2,3,10
originale,0,0,0,0,1,1
jumbo,0,1,0,0,0,1
squarebiz,1,1,0,1,0,3
groove,4,3,2,2,3,14
knucklebuster,1,1,0,0,0,2
flow,1,3,1,0,1,6
single,13,7,5,8,8,41
cafe,2,1,0,2,0,5
obicham,1,0,0,0,1,2
fattasly,1,1,1,1,1,5
streit,0,0,0,1,0,1
terraplane,1,0,0,0,0,1
bubblegum,1,0,1,1,1,4
reputation,1,1,0,0,1,3
ellen,1,1,0,1,0,3
irreplaceable,1,1,0,0,1,3
wonderin,1,1,1,0,1,4
papi,1,0,0,1,1,3
amidar,1,1,1,1,1,5
gross,1,0,1,1,0,3
favourite,1,1,0,0,0,2
papa,4,3,0,1,3,11
yango,1,1,0,1,1,4
oedipus,0,0,0,0,3,3
fishes,1,1,0,0,1,3
desert,1,0,2,0,1,4
bohemios,1,0,0,0,1,2
trofimov,1,0,0,1,0,2
dixneuvime,0,0,0,1,0,1
malandro,1,1,0,1,0,3
presenting,0,1,0,0,1,2
fhrt,1,1,0,1,1,4
qian,0,0,0,0,1,1
groceries,1,0,0,0,0,1
vietnamese,1,0,1,0,0,2
peanut,0,1,0,0,0,1
makossa,0,1,0,0,0,1
bitomu,0,0,0,1,1,2
germain,0,1,0,1,0,2
intensiva,1,0,0,0,1,2
affettuoso,1,0,0,1,1,3
fatal,1,1,0,1,1,4
garou,1,1,1,1,1,5
joyride,1,0,0,1,1,3
saudade,1,1,0,1,1,4
rhyme,1,0,1,0,0,2
robbery,1,0,0,0,0,1
ausente,0,1,0,1,0,2
assai,1,0,0,1,1,3
knight,1,0,0,1,1,3
conc,0,0,0,0,1,1
joes,1,1,1,1,1,5
squarepants,1,0,0,1,1,3
mobilize,1,1,1,1,1,5
havent,1,0,1,0,0,2
delgaty,1,0,0,0,0,1
diluvio,0,0,0,0,1,1
bleeding,1,0,0,0,1,2
crow,2,1,1,1,1,6
tekee,1,0,0,0,1,2
carli,1,0,1,0,1,3
belleza,1,0,0,1,1,3
elisa,1,1,1,1,1,5
depression,1,0,0,0,1,2
lombre,0,1,0,1,0,2
chicago,5,3,2,2,4,16
anthem,2,0,1,3,3,9
emergencia,0,0,0,0,1,1
suruinen,1,1,0,0,1,3
denke,1,1,1,1,1,5
sicilienne,1,1,0,1,1,4
bullmoose,1,1,0,0,1,3
body,2,1,2,3,4,12
exchange,0,1,0,0,0,1
nonexistent,1,0,1,1,1,4
packing,1,0,0,0,0,1
healing,2,2,1,3,1,9
sing,4,6,1,3,7,21
nacht,4,1,1,4,4,14
cero,0,1,0,1,0,2
garcon,1,0,0,0,1,2
climb,1,0,0,0,0,1
named,1,0,0,0,1,2
presidents,1,0,0,1,0,2
marelle,1,1,1,1,1,5
private,1,1,0,1,1,4
neuza,0,0,0,1,0,1
limn,1,0,0,1,0,2
resolutions,1,0,0,0,1,2
gateway,1,0,0,1,1,3
sermon,1,1,1,1,1,5
cierro,1,0,1,1,1,4
hammered,0,1,0,1,0,2
laventurier,1,1,0,1,1,4
popsy,0,1,0,0,1,2
emmaus,0,0,0,1,0,1
astoria,1,0,1,0,1,3
train,17,10,8,10,14,59
pirame,1,0,0,1,1,3
tearing,1,0,0,0,1,2
harvest,0,1,0,0,0,1
spaniolandia,0,0,0,1,0,1
fooling,2,2,0,1,2,7
espagnole,1,1,0,1,1,4
britney,1,0,1,0,1,3
tunnel,2,0,2,0,1,5
gabriel,1,0,0,1,1,3
obvious,1,1,1,0,0,3
praise,0,1,0,1,0,2
closing,1,0,0,1,1,3
didnt,7,2,4,1,1,15
athenry,1,0,0,1,0,2
precs,1,0,1,0,0,2
twilliams,0,0,0,1,0,1
scarface,1,0,0,0,1,2
chakra,2,2,0,2,0,6
globillyveevee,0,1,0,0,0,1
native,0,1,0,1,0,2
voini,1,0,0,1,0,2
bakwetu,1,1,0,1,1,4
noises,1,1,1,0,0,3
boxing,1,0,1,0,1,3
forest,3,2,2,2,2,11
stasis,1,0,0,0,0,1
falta,3,0,2,1,3,9
autobiography,0,1,0,0,1,2
waters,1,1,1,1,0,4
collection,0,1,0,0,1,2
bothered,1,0,0,0,1,2
bluff,0,0,1,0,0,1
klan,1,1,0,0,1,3
gammal,1,0,0,0,0,1
kashmiri,0,0,0,0,1,1
chasing,3,2,2,2,3,12
kuang,0,1,0,0,1,2
bing,1,0,1,0,0,2
itsy,1,0,1,1,1,4
bina,0,0,0,1,0,1
piacere,1,0,0,0,1,2
querido,0,0,0,1,1,2
laurie,0,1,0,0,1,2
likua,1,0,0,0,1,2
lucindy,1,0,0,0,1,2
chteau,1,1,1,1,1,5
horns,2,2,1,2,2,9
thyself,1,0,1,1,0,3
johanna,1,0,0,0,1,2
galaxy,1,0,0,1,1,3
bunch,1,1,0,1,1,4
bridges,1,1,0,1,1,4
bridget,1,1,0,0,1,3
brian,0,1,0,0,1,2
sporco,2,2,0,2,2,8
winning,1,1,1,1,0,4
pginas,0,0,0,0,1,1
junction,1,0,0,1,0,2
greater,0,0,0,1,0,1
spell,1,2,0,0,0,3
mambazo,1,1,0,0,1,3
blessed,1,0,0,0,1,2
volant,0,0,0,0,1,1
cutting,1,0,1,0,0,2
legged,1,1,0,0,0,2
sonata,2,0,0,2,2,6
february,1,1,0,0,1,3
thrill,3,1,1,2,3,10
recuerdo,1,0,0,0,1,2
slipping,2,1,2,2,2,9
lively,1,1,0,0,1,3
dixie,1,1,0,0,2,4
dreaming,3,1,2,2,3,11
programmed,0,0,1,0,0,1
drumroll,1,1,1,1,0,4
junkie,2,1,1,0,2,6
firebirdapparition,0,1,0,0,0,1
manteca,0,1,0,1,0,2
defend,1,0,0,0,1,2
jamaiquino,0,1,0,1,0,2
mate,1,1,0,1,0,3
ridaz,1,1,0,1,1,4
frank,3,2,1,2,4,12
compra,1,1,1,1,1,5
bleed,2,0,2,0,2,6
midn,1,1,0,1,1,4
yard,1,0,0,0,1,2
seor,1,0,0,0,1,2
deprived,1,0,1,1,0,3
south,4,3,1,3,1,12
suffit,0,0,0,0,1,1
philadelphia,1,0,0,0,1,2
franks,1,0,0,1,0,2
hillcrest,1,0,0,0,0,1
bezell,0,0,0,1,0,1
monkey,5,3,1,3,2,14
dutty,0,0,0,1,0,1
tropeau,0,1,0,1,1,3
roche,1,1,0,0,1,3
palestine,0,0,1,0,1,2
jingle,3,1,0,0,3,7
parchman,2,1,2,2,0,7
natty,0,0,0,1,0,1
dichoso,1,1,0,1,1,4
negra,0,0,0,0,1,1
gear,1,0,1,1,1,4
nieman,1,1,1,1,1,5
bulldog,1,1,0,1,0,3
nobody,5,2,0,2,4,13
highlands,1,0,0,0,1,2
oaktown,1,0,1,0,0,2
boobie,0,0,1,0,0,1
fabbricaeuropa,0,0,0,1,0,1
wishlist,1,0,1,0,1,3
skyswimmer,1,0,1,1,0,3
abstracto,1,0,1,0,1,3
loved,6,2,1,2,6,17
babys,4,2,0,2,3,11
slack,1,0,1,0,0,2
cantares,1,0,1,1,1,4
cancon,0,0,0,1,1,2
desiguais,1,1,0,1,1,4
drunnhvita,0,1,0,1,0,2
loves,10,7,5,6,8,36
lover,10,6,3,10,9,38
flashes,1,1,0,1,0,3
inna,1,0,0,1,0,2
wakes,0,1,0,1,0,2
nativit,0,1,0,1,0,2
recuso,1,1,0,0,1,3
tide,3,2,2,3,4,14
thataway,1,0,0,1,0,2
have,28,21,13,19,23,104
dementia,1,0,1,1,0,3
dallas,1,0,0,0,0,1
cuore,1,1,0,1,1,4
precipice,0,1,0,1,0,2
espana,1,1,1,1,1,5
eres,0,2,0,0,1,3
tromba,1,0,0,0,1,2
henrys,1,0,0,1,0,2
eight,2,1,1,1,2,7
vollmond,1,0,0,0,0,1
sally,3,0,2,1,2,8
jaan,0,0,1,1,1,3
unlove,0,0,0,0,1,1
gigue,1,1,0,0,1,3
shouther,0,2,0,0,0,2
stranded,1,0,1,0,0,2
request,1,0,0,0,1,2
disease,1,0,1,0,0,2
tenhert,1,0,1,0,0,2
rendezvous,1,0,1,1,1,4
skinny,0,1,0,0,0,1
capito,0,0,0,1,0,1
elevador,1,1,1,1,1,5
charley,0,1,0,0,1,2
kite,1,1,1,1,1,5
rytmikone,1,0,1,0,1,3
ithaki,0,0,0,0,1,1
chiaroscuro,0,0,0,1,0,1
kakou,1,1,0,1,1,4
sparky,1,1,1,1,1,5
knowledge,2,1,0,2,1,6
blowin,1,1,0,0,0,2
epilog,1,0,1,0,1,3
anythings,0,0,0,0,1,1
bernard,1,1,0,0,0,2
satan,1,1,0,1,1,4
annaleah,1,0,1,0,1,3
inferior,1,0,1,0,1,3
photographs,1,0,0,1,1,3
beat,8,5,5,6,7,31
loba,1,0,0,0,1,2
souvre,1,0,0,0,1,2
bear,2,0,0,1,2,5
beam,0,1,0,1,1,3
bean,2,2,2,2,2,10
october,1,1,1,1,1,5
perfection,1,0,0,1,0,2
assface,1,0,0,0,1,2
diplo,0,0,0,1,0,1
organ,1,0,0,0,1,2
rage,1,0,0,0,0,1
calling,2,1,2,3,2,10
rakkauden,2,1,1,0,2,6
constructing,0,0,0,1,0,1
national,0,1,0,1,1,3
machuca,1,0,0,0,1,2
frierson,1,1,0,0,1,3
brixton,1,0,1,1,0,3
existe,1,1,0,1,1,4
yearning,1,0,0,0,1,2
intensity,1,0,1,0,0,2
shte,1,0,0,0,1,2
walking,7,4,0,6,7,24
epic,1,0,0,1,1,3
epaule,1,0,1,1,1,4
lupe,1,0,0,0,1,2
bruno,1,0,0,0,0,1
playboys,1,1,0,1,1,4
progress,0,0,0,1,1,2
waheera,0,1,0,0,0,1
instumental,1,0,1,0,1,3
janes,2,0,0,1,1,4
janet,0,0,0,0,1,1
junkies,1,0,1,1,0,3
sorrow,2,1,1,1,0,5
monarchy,1,1,0,1,1,4
herione,1,0,0,0,1,2
habanera,0,1,0,1,0,2
prtention,1,0,1,1,1,4
joke,1,0,0,0,0,1
taking,1,0,0,0,0,1
conmigo,2,1,1,1,2,7
succotash,1,0,1,1,0,3
tates,1,0,1,1,1,4
busted,1,1,0,0,1,3
orfeo,1,1,0,0,0,2
usurperescapemartyrspiral,1,1,0,0,0,2
swallow,1,0,0,0,0,1
highland,1,1,0,1,1,4
vent,1,0,0,1,0,2
starspangled,1,1,0,0,1,3
agrymonyzer,0,0,0,1,0,1
eriatarka,1,0,1,1,0,3
reborn,2,0,1,1,0,4
vena,1,1,0,1,0,3
laugh,3,1,3,3,3,13
cendrier,1,0,0,1,1,3
delirio,1,2,0,0,1,4
muddy,1,0,0,1,0,2
gaze,1,1,1,0,1,4
arteest,1,0,0,0,1,2
rammembri,1,0,0,0,1,2
yesterdays,2,4,1,3,4,14
protect,0,0,0,1,0,1
tenderly,2,2,0,0,2,6
tense,1,0,1,0,0,2
mundo,1,0,0,0,1,2
bull,4,4,2,3,4,17
waterhole,1,0,0,1,0,2
blacksun,1,0,0,1,0,2
cypher,1,1,1,1,1,5
brasilia,1,1,0,1,1,4
widescreen,1,0,0,1,1,3
elisabetta,1,0,0,0,1,2
techtonic,0,1,0,1,0,2
helper,1,0,1,0,1,3
almost,2,4,2,1,2,11
weighed,1,0,0,1,1,3
belina,0,1,0,1,1,3
palavras,0,1,0,0,0,1
partner,5,2,0,3,2,12
fezbeing,1,1,1,1,1,5
plexis,0,1,0,0,0,1
tiempo,1,1,0,0,1,3
material,1,0,1,0,0,2
sizofrenijaduet,0,0,0,0,1,1
spitting,1,0,1,0,1,3
fucked,1,0,0,0,1,2
sigui,0,1,0,1,1,3
sete,1,1,0,1,1,4
eurydice,1,0,0,1,1,3
center,2,0,1,1,2,6
weapon,2,2,0,1,0,5
rapino,1,1,1,1,1,5
thought,1,1,1,1,1,5
position,1,0,1,1,0,3
wreckage,1,0,1,0,1,3
barking,1,0,0,1,1,3
damour,2,2,0,1,4,9
xian,0,0,0,1,1,2
abai,0,1,0,1,0,2
oracin,1,0,1,1,1,4
underlying,1,0,0,1,1,3
books,2,0,0,0,1,3
situacija,0,0,0,1,0,1
quiero,6,2,2,5,8,23
loquillo,1,0,1,0,1,3
chorinho,2,2,2,2,2,10
quiere,0,0,0,0,1,1
smpty,1,0,0,1,0,2
lake,1,0,1,4,2,8
cybernetic,1,0,1,1,1,4
monnaie,0,1,0,0,1,2
citizen,1,0,0,1,1,3
twerk,0,1,0,1,1,3
crass,2,1,0,0,2,5
tonk,1,1,0,1,1,4
smart,1,1,0,0,1,3
worlds,2,1,1,1,1,6
steklu,0,0,0,1,1,2
cicatriz,1,0,1,1,1,4
jonki,1,0,0,0,1,2
like,44,27,23,32,38,164
success,1,1,0,1,1,4
darcy,0,1,0,0,1,2
chica,1,1,0,1,1,4
cantando,1,1,0,0,0,2
sarajevo,1,0,0,1,1,3
pyar,0,0,0,1,0,1
chick,1,0,1,1,0,3
works,1,0,0,0,0,1
leducation,1,1,0,0,1,3
chico,0,0,0,0,1,1
italian,0,0,0,1,1,2
tetaz,1,0,0,1,1,3
alive,9,3,4,6,8,30
hair,2,0,1,2,2,7
manigances,1,1,1,1,1,5
oblivious,1,0,1,0,0,2
happens,1,0,1,1,0,3
coombe,1,1,0,0,1,3
hurricane,1,0,0,1,1,3
rattlesnake,1,1,1,0,1,4
joachim,0,1,0,1,1,3
wout,1,1,0,1,1,4
quinze,0,1,0,0,1,2
screwed,0,0,0,0,4,4
chains,3,1,0,2,4,10
rumpu,0,0,0,0,1,1
slight,2,2,1,1,1,7
sasha,1,1,1,1,1,5
expire,1,0,1,1,1,4
retribution,1,1,1,1,1,5
about,16,9,4,9,14,52
quills,1,1,0,1,1,4
boards,1,0,0,1,0,2
flake,1,0,1,0,1,3
flashflood,0,1,0,1,1,3
turandot,1,0,0,1,0,2
tomb,1,0,1,1,1,4
alexanders,0,1,0,0,1,2
unreleased,2,1,1,1,1,6
faithfulness,3,3,2,3,2,13
childrens,0,1,0,0,0,1
obliterated,1,1,0,1,1,4
socks,1,0,0,0,1,2
guard,0,0,0,0,1,1
doesnt,3,1,2,1,3,10
eine,1,0,0,1,1,3
eshiha,0,0,1,1,1,3
termina,1,1,0,1,1,4
timbal,1,1,0,1,0,3
daubrac,0,1,0,0,1,2
yorkers,1,0,0,1,0,2
stainless,1,0,0,0,1,2
toutes,1,1,0,1,1,4
banzai,1,0,0,1,0,2
rushes,0,0,0,1,0,1
oiseaux,2,0,1,1,2,6
lamboy,1,0,0,1,1,3
chlore,1,0,1,1,1,4
dieters,1,0,0,1,1,3
ivory,2,0,2,1,0,5
coke,1,0,1,0,1,3
sequel,1,1,0,0,0,2
santas,1,1,0,1,0,3
plague,1,0,1,0,0,2
santaf,0,0,0,0,1,1
memphis,5,5,4,2,6,22
seis,0,1,0,0,0,1
misty,4,1,0,2,3,10
ageya,0,0,0,0,1,1
glory,6,4,3,3,3,19
seit,1,0,1,1,1,4
caminante,0,1,0,1,0,2
variations,4,0,0,4,6,14
byob,0,0,0,1,1,2
veteraani,1,0,1,0,1,3
minutes,3,1,1,1,3,9
sein,3,1,1,1,1,7
supreme,0,0,1,0,1,2
garter,1,0,0,1,1,3
domino,1,0,0,0,1,2
crusade,0,2,0,2,2,6
barnyards,1,0,0,0,0,1
baos,1,1,0,1,1,4
mash,1,0,0,1,1,3
dressed,0,1,0,0,0,1
mast,0,0,0,0,1,1
balao,1,1,0,1,0,3
stocne,1,1,1,0,1,4
shouldve,1,0,0,0,1,2
variation,3,2,1,3,2,11
westlate,0,2,0,0,0,2
bitsy,1,0,1,1,1,4
goin,7,3,3,2,6,21
baker,1,0,0,1,1,3
cuycha,0,1,0,0,0,1
yell,1,0,0,0,0,1
kinghead,1,1,0,1,1,4
sleep,3,0,1,1,1,6
nosatellites,0,0,1,1,0,2
dere,0,1,0,1,1,3
veux,1,1,1,1,1,5
trolley,1,1,0,0,1,3
paris,5,5,2,6,4,22
tween,1,0,0,1,1,3
posledny,1,0,0,1,0,2
under,10,5,4,7,7,33
regrets,3,1,2,3,3,12
haughtiness,1,0,1,1,1,4
rise,6,2,2,2,3,15
every,7,1,4,4,5,21
jack,6,4,4,4,6,24
caput,0,0,0,0,1,1
yodel,1,1,0,0,0,2
cerillas,0,1,0,0,1,2
monkeys,1,0,0,0,0,1
missionary,1,0,0,1,1,3
trascorrono,0,0,0,0,1,1
school,3,1,2,1,0,7
soundtracks,1,1,0,1,0,3
anfang,1,0,1,1,1,4
venus,1,0,1,1,1,4
decidio,1,1,0,1,1,4
pooley,0,0,0,1,1,2
enjoy,3,0,3,0,3,9
throught,1,0,1,0,1,3
nail,1,1,0,0,0,2
lian,1,0,0,0,1,2
street,17,10,2,10,11,50
matrosen,1,0,1,1,0,3
shining,3,1,1,3,1,9
blue,29,16,8,19,25,97
hide,1,1,0,0,1,3
christ,2,0,1,2,2,7
kaotica,1,0,0,1,1,3
lenfant,0,1,0,1,0,2
revolver,1,0,0,0,1,2
liberty,1,0,1,1,1,4
sung,3,0,0,0,3,6
liberte,0,0,1,1,1,3
xvii,1,0,0,1,1,3
nubia,1,1,1,1,1,5
impartial,1,0,1,1,1,4
zack,1,1,0,1,1,4
molly,1,0,0,0,1,2
shontelle,1,1,1,1,1,5
pata,2,2,0,2,2,8
studio,3,1,1,1,2,8
lero,0,1,0,0,0,1
aftermath,1,0,1,0,0,2
stares,1,0,1,1,0,3
biloxi,1,0,0,0,0,1
tinsel,1,0,1,1,0,3
exactamente,1,1,0,0,1,3
leaves,2,2,0,2,2,8
changed,3,1,1,1,3,9
amante,0,0,0,0,1,1
populaire,0,0,0,0,1,1
chateau,1,0,0,0,0,1
changes,2,1,1,2,2,8
agrippina,1,0,0,0,1,2
straw,1,1,1,2,2,7
gwine,0,0,0,1,0,1
loveless,1,0,0,1,1,3
feelings,0,1,0,2,2,5
sorrows,1,0,0,1,0,2
patience,1,0,1,1,1,4
outro,9,3,1,7,4,24
rhumboso,0,1,0,1,0,2
would,6,5,4,2,4,21
bayou,2,0,0,1,1,4
christelle,1,1,1,1,1,5
breathe,3,2,0,1,2,8
sabes,1,1,0,0,0,2
muse,1,0,0,0,0,1
comfortubly,1,1,0,1,1,4
phone,3,2,2,2,2,11
sting,3,1,1,2,2,9
cuttin,1,1,1,1,1,5
organic,0,1,0,0,0,1
bambola,1,0,0,0,1,2
coppershot,1,0,1,1,1,4
must,6,2,2,3,5,18
shoot,5,1,1,2,6,15
join,1,0,1,1,0,3
lukas,0,0,0,0,1,1
grandpno,1,1,1,1,1,5
everafter,1,1,0,0,1,3
fortress,1,0,0,1,1,3
estate,0,2,0,1,1,4
gwendolina,1,1,0,1,1,4
potria,1,0,0,1,0,2
ratkaisee,1,1,1,1,1,5
rakastan,1,0,0,0,0,1
times,10,6,3,3,5,27
rakastaa,0,0,0,1,1,2
ceremony,1,1,1,0,1,4
billville,0,1,1,0,0,2
iiii,1,1,1,1,0,4
drummer,2,2,1,1,0,6
gate,2,0,0,0,1,3
labios,1,0,0,0,1,2
poker,1,0,0,1,1,3
elizabeth,1,1,0,0,0,2
mess,2,0,1,1,1,5
jumping,2,1,2,2,1,8
salsa,0,2,0,2,4,8
parallel,1,1,1,0,1,4
danny,2,1,0,0,2,5
amie,1,0,0,0,1,2
upside,1,0,1,0,1,3
jungle,6,3,5,5,2,21
suerte,0,0,0,0,1,1
harlem,4,3,1,1,4,13
amis,1,1,1,1,1,5
friars,1,1,0,0,1,3
deform,1,0,1,1,0,3
over,24,16,14,18,24,96
chowbay,1,1,1,1,1,5
historys,1,1,1,1,0,4
london,1,0,0,1,1,3
crumbs,1,0,1,1,0,3
mallarm,0,0,0,1,0,1
asesname,1,0,1,1,1,4
pkin,1,0,0,0,1,2
lantillais,0,0,0,1,1,2
canta,2,1,1,0,2,6
hypocrisy,1,0,1,0,0,2
canto,1,1,0,1,1,4
edith,1,1,0,0,0,2
baila,2,0,0,2,1,5
writing,1,1,0,0,0,2
creepshow,1,0,0,1,1,3
nuoruusmuistoja,1,1,0,0,1,3
fade,4,0,1,1,4,10
fofo,1,0,0,0,1,2
riff,1,0,0,0,1,2
blott,0,1,0,0,0,1
suene,0,1,0,0,0,1
revelations,3,2,2,2,2,11
lento,2,0,2,2,2,8
shadows,3,2,1,3,2,11
alex,1,1,1,1,1,5
mammas,0,1,0,0,1,2
detroit,3,1,2,4,4,14
explode,3,1,2,2,2,10
holdin,2,1,1,1,1,6
each,5,1,3,3,3,15
victors,0,1,0,0,1,2
hank,3,0,2,2,3,10
diana,2,2,1,0,1,6
moose,1,1,0,1,0,3
group,1,0,0,0,1,2
autre,1,0,1,1,1,4
loafting,0,0,0,1,0,1
hanged,1,0,0,0,0,1
ghosts,2,1,2,0,0,5
saturday,6,1,3,4,6,20
driving,3,2,1,3,3,12
motel,1,0,0,1,0,2
washed,1,1,1,1,1,5
duction,1,1,0,1,1,4
mayday,1,0,0,0,0,1
nite,2,0,0,2,1,5
heavenly,2,2,2,2,1,9
washes,1,1,1,1,1,5
reja,0,1,0,0,0,1
independence,1,0,0,0,1,2
frei,2,0,0,0,0,2
perception,1,1,1,1,1,5
carcass,1,0,1,0,0,2
gammer,1,0,1,1,1,4
eternal,1,0,1,0,0,2
free,12,7,7,8,9,43
fred,1,0,0,0,1,2
begleiten,1,1,1,1,1,5
streamline,1,0,0,0,1,2
rain,19,8,11,8,15,61
netait,1,1,0,1,1,4
wanted,2,0,1,3,1,7
dabdabdooparty,1,0,0,1,1,3
baals,1,1,1,1,1,5
days,22,11,8,10,16,67
soda,2,0,0,0,1,3
shootin,1,1,1,1,1,5
marwa,1,0,0,1,1,3
rang,0,0,0,1,1,2
magico,1,0,1,0,1,3
puck,0,0,1,0,0,1
primary,1,0,1,0,0,2
fantasy,0,0,0,1,1,2
sober,1,1,0,0,1,3
aikaa,1,0,0,1,1,3
dysfunction,0,1,0,1,0,2
mercury,2,1,1,2,0,6
lovebite,1,0,0,1,1,3
attack,4,3,0,4,3,14
hustlin,1,0,0,0,0,1
rockin,3,2,1,1,2,9
firestarter,1,0,1,1,1,4
urban,0,0,0,1,0,1
murder,5,2,4,4,4,19
indiscreet,0,1,0,0,0,1
serve,1,0,1,1,0,3
took,3,3,0,3,2,11
western,2,0,0,0,1,3
litler,1,1,1,1,1,5
scenario,1,1,0,0,1,3
flama,0,0,0,0,1,1
flame,3,1,0,2,0,6
olerkia,0,0,0,0,1,1
guaguanco,1,1,0,0,0,2
bridge,2,2,0,2,4,10
talking,4,3,2,4,3,16
clubstar,1,0,1,1,1,4
snow,3,4,2,1,3,13
bleib,1,0,0,1,1,3
maxi,1,0,1,1,1,4
derek,1,1,0,1,1,4
shelf,1,0,0,0,1,2
snob,1,1,0,1,1,4
sparro,0,1,0,1,1,3
rider,1,1,0,1,1,4
dial,0,0,0,1,0,1
excelling,0,1,0,0,1,2
passover,1,0,0,1,1,3
coil,1,0,1,1,0,3
tibetan,0,1,0,1,0,2
glow,2,1,2,1,2,8
flor,1,0,0,1,2,4
kleine,2,1,0,2,2,7
metal,2,0,3,1,2,8
kleina,0,0,0,1,0,1
yang,0,0,0,1,2,3
cambia,1,1,1,1,0,4
velarde,1,0,0,0,1,2
sanctuary,1,0,0,0,0,1
coeur,4,2,1,3,4,14
saga,0,1,0,1,0,2
queen,5,1,2,4,5,17
colors,0,0,0,1,0,1
reissue,2,0,0,0,0,2
radio,15,8,10,15,18,66
earth,10,5,4,4,8,31
sagt,1,1,1,1,1,5
adoration,0,1,0,0,0,1
claude,1,1,1,1,1,5
situations,0,0,0,1,0,1
farenheit,0,0,0,1,0,1
stephane,0,0,0,1,0,1
gods,1,1,0,1,1,4
sedona,0,0,0,1,0,1
getdown,0,0,0,1,0,1
mixture,1,0,1,1,1,4
watch,2,2,1,2,2,9
fluid,2,2,0,1,1,6
geek,1,1,0,0,0,2
goons,1,0,0,0,1,2
wedding,4,3,0,1,3,11
rhymin,1,1,1,0,0,3
goodbyes,1,0,1,1,0,3
reminissin,0,0,0,1,1,2
public,1,0,1,0,0,2
peroxide,0,1,0,0,1,2
automatic,1,0,0,0,1,2
habit,1,0,0,0,0,1
resist,1,1,0,1,1,4
machst,1,0,0,1,1,3
bonnies,0,1,0,0,1,2
hourglass,1,0,1,1,0,3
combustion,1,1,0,1,1,4
malice,1,0,0,0,0,1
hoedown,1,1,1,1,1,5
finger,2,0,0,1,2,5
oniro,1,0,0,0,1,2
cajun,5,2,1,0,4,12
blaster,1,1,1,1,1,5
confusion,1,0,1,1,1,4
weak,1,0,0,0,0,1
boss,1,1,0,1,2,5
wear,2,2,1,2,2,9
badrock,1,0,1,1,1,4
news,1,0,0,0,0,1
hills,1,1,0,2,0,4
faced,1,1,0,0,0,2
goddess,2,1,0,1,1,5
fault,1,1,1,1,1,5
players,0,0,0,1,0,1
games,2,2,1,0,4,9
rpido,1,0,1,1,1,4
faces,1,1,1,1,1,5
amarela,1,1,0,0,1,3
trust,3,2,1,2,3,11
hitler,1,0,0,0,1,2
bathroom,1,0,0,0,1,2
alchemy,1,1,0,0,1,3
been,13,8,2,6,12,41
backlash,0,0,0,1,0,1
beer,1,1,0,0,1,3
tenemos,1,0,0,0,1,2
drillrework,1,1,1,1,1,5
corazn,3,2,2,2,2,11
fleeting,0,0,0,1,0,1
drugs,1,0,1,1,0,3
steamroller,1,0,0,0,1,2
krause,1,1,0,1,0,3
catch,2,0,0,0,1,3
dept,1,0,1,1,1,4
teachers,1,0,1,0,1,3
stopping,1,1,1,0,1,4
cracked,1,0,1,1,0,3
gave,2,1,1,1,2,7
lebaran,1,0,0,1,0,2
ciganos,0,1,0,0,0,1
veronica,1,0,0,0,1,2
runaround,1,0,0,0,1,2
kcrw,1,0,1,0,0,2
madres,0,0,0,1,1,2
opelousas,1,0,0,0,1,2
latinas,1,1,0,1,1,4
shawty,0,0,0,1,0,1
satellite,1,1,1,1,1,5
maubeuge,0,0,0,1,1,2
negativ,0,0,0,1,0,1
theodore,0,1,0,0,1,2
milky,1,1,0,0,0,2
hundre,1,0,0,0,0,1
action,3,0,2,1,2,8
saintjean,0,1,0,0,1,2
angle,1,0,0,0,1,2
viimeinen,1,0,1,1,1,4
cycle,1,0,0,1,1,3
dylan,2,1,0,1,2,6
giorgi,1,0,0,1,1,3
charlie,2,1,2,1,1,7
ocean,8,4,6,5,5,28
strangerhood,1,0,1,1,0,3
greatest,3,2,1,0,2,8
rockout,1,0,1,1,0,3
mother,9,5,3,5,9,31
hearts,8,4,4,6,8,30
jean,4,2,0,2,4,12
rubies,1,1,0,1,1,4
amame,0,0,0,0,1,1
zolte,1,0,1,1,1,4
frlskad,1,1,0,0,1,3
tetrispack,0,0,0,1,0,1
sabados,1,0,1,0,1,3
scorpio,1,1,0,1,1,4
cherry,3,0,1,3,3,10
chaudrons,0,1,0,0,0,1
flashover,0,1,0,1,1,3
humanity,1,0,1,1,0,3
anya,0,1,0,0,1,2
turquoise,0,1,0,1,0,2
breakz,1,0,1,1,1,4
hermitage,1,1,0,0,0,2
breaks,2,1,0,1,1,5
vulture,1,0,1,1,0,3
cultural,1,1,0,1,1,4
espressivo,1,0,0,1,1,3
judge,1,0,0,0,0,1
banda,2,1,0,1,2,6
apart,0,2,0,1,1,4
melting,1,0,1,1,1,4
everrett,1,1,0,1,1,4
appearing,1,0,0,1,1,3
gift,1,1,0,0,1,3
mosquito,1,0,1,1,0,3
hung,1,0,0,0,0,1
amor,18,9,3,9,19,58
larghetto,1,0,1,0,1,3
clubb,1,0,0,1,1,3
acab,1,0,0,0,0,1
spongebob,1,0,0,1,1,3
excerpt,0,0,0,0,1,1
pushbike,1,1,1,1,1,5
escape,4,2,1,1,3,11
skymning,1,0,0,1,0,2
eugenes,1,1,1,1,1,5
stumblin,1,0,1,1,1,4
everything,13,6,7,9,12,47
christmas,23,11,6,12,21,73
triste,2,1,0,0,1,4
sukkubus,1,0,0,1,0,2
coro,1,0,0,0,2,3
disappeared,1,1,1,1,1,5
maschinenkult,1,0,0,1,0,2
chapter,2,0,0,0,0,2
cowboy,2,1,1,1,2,7
sepa,1,0,0,0,1,2
choke,1,0,0,0,0,1
dinner,1,1,0,1,1,4
plus,6,5,3,6,6,26
mismo,1,0,1,1,1,4
sept,1,1,0,1,1,4
mortva,1,0,1,0,0,2
duke,1,0,1,0,1,3
bata,0,1,0,0,1,2
civic,1,0,1,0,0,2
puzzle,1,1,1,1,1,5
gham,0,0,0,1,0,1
bath,2,1,0,1,3,7
javas,0,1,0,1,1,3
nihilo,1,0,0,0,0,1
piouhgd,1,0,0,1,1,3
dreamin,1,1,1,1,1,5
stuck,4,1,2,3,2,12
anderson,0,0,0,0,1,1
wildflower,1,0,0,0,1,2
ilbert,1,1,0,1,1,4
head,20,10,5,12,15,62
medium,2,0,0,0,2,4
traidor,1,0,1,0,1,3
heal,2,0,2,2,2,8
schauet,1,1,1,1,1,5
heat,1,0,1,0,0,2
uncle,1,1,1,1,0,4
solas,1,1,1,1,0,4
bernice,1,0,1,0,1,3
viva,0,0,0,0,1,1
witchdoctor,1,1,0,1,1,4
vivo,4,0,1,1,3,9
versione,0,0,1,1,0,2
adore,1,1,0,1,1,4
atto,1,0,0,1,2,4
arabes,1,1,0,0,0,2
camara,1,1,0,0,0,2
brisa,0,1,0,0,0,1
raha,1,1,1,1,1,5
micael,1,0,1,1,1,4
fury,1,1,1,1,1,5
honeybabe,1,1,0,0,0,2
bulgarian,1,0,0,0,1,2
traviata,1,0,0,1,0,2
sometime,1,1,0,0,1,3
cocain,1,0,0,1,0,2
acclaimed,1,0,1,1,1,4
juntos,0,0,0,0,1,1
shines,3,1,3,1,3,11
check,2,3,0,3,2,10
junto,1,0,0,1,2,4
damisela,0,1,0,0,0,1
faithful,1,3,0,1,0,5
marys,1,1,0,1,1,4
mashup,1,0,0,1,0,2
percaria,0,1,0,0,0,1
when,42,19,14,23,32,130
desce,0,1,0,0,0,1
setting,1,1,0,1,0,3
papers,1,1,0,0,1,3
evergreen,1,0,1,1,1,4
picture,1,1,0,1,1,4
brivdiena,1,1,0,0,1,3
tarraxa,0,0,0,1,0,1
eiffel,1,0,0,1,1,3
discharge,1,1,0,0,1,3
scratchy,1,0,0,0,1,2
siento,1,1,1,1,0,4
sellack,1,1,0,0,1,3
faster,2,2,0,1,1,6
bullet,2,2,1,2,1,8
ryder,1,1,1,1,1,5
juguete,1,1,1,1,0,4
bamba,1,1,0,1,1,4
jolson,1,1,0,0,0,2
focus,0,1,0,2,1,4
cancion,4,0,2,3,2,11
finisterre,1,0,0,1,1,3
passage,2,1,0,2,1,6
eisbr,1,1,1,1,1,5
verliebt,1,1,1,1,1,5
fuiste,1,0,1,0,1,3
frequencies,0,1,0,1,0,2
krazy,2,1,0,1,1,5
none,1,0,1,1,0,3
sloppy,2,0,1,1,2,6
vestido,1,0,0,0,1,2
deirdre,0,1,0,1,0,2
cool,9,6,1,5,7,28
clouds,1,0,0,1,0,2
valentin,1,0,0,1,0,2
brother,9,3,3,3,4,22
levee,1,0,0,0,0,1
youngs,1,0,0,0,1,2
espanol,0,0,0,1,1,2
quick,1,0,0,0,1,2
yall,1,0,0,0,0,1
sanguinis,1,1,0,1,1,4
says,5,3,3,4,4,19
exsvles,1,0,1,0,0,2
confiaste,1,0,0,1,0,2
colin,2,1,0,2,0,5
steppin,2,2,1,1,1,7
voucher,1,0,1,0,0,2
chicken,1,0,1,1,1,4
phorever,1,0,1,1,1,4
hymn,3,2,1,3,2,11
corba,0,1,0,0,1,2
seule,1,1,1,1,1,5
goes,6,4,1,6,7,24
reply,1,0,0,1,1,3
ayee,1,1,1,1,1,5
water,6,4,0,2,4,16
witch,1,0,1,0,0,2
boogaloo,1,3,0,2,1,7
aunque,1,1,1,0,0,3
unidentified,1,1,1,1,1,5
regnen,1,1,1,1,1,5
automator,1,0,0,0,1,2
pearls,1,1,0,1,1,4
guilty,2,0,0,2,2,6
molto,1,1,0,1,1,4
cinnamon,1,0,1,0,0,2
emerge,1,0,1,0,0,2
pusfilled,1,0,1,0,0,2
tempteth,0,0,1,0,1,2
ethiopian,0,0,0,1,0,1
paralyzed,1,1,1,1,1,5
prem,1,1,0,1,1,4
kalanta,1,0,0,0,1,2
stephin,1,0,0,1,1,3
sports,1,1,0,0,1,3
parties,1,0,0,0,0,1
vivir,1,0,0,1,0,2
andy,1,0,1,1,1,4
memory,2,1,0,2,3,8
megaton,0,1,0,0,1,2
australian,1,1,0,0,1,3
today,4,1,3,3,2,13
riot,3,1,3,0,1,8
sessions,2,0,1,1,1,5
altas,1,0,0,1,1,3
altar,1,1,1,1,1,5
ayer,2,0,0,2,1,5
chocolate,1,0,1,0,1,3
drown,1,2,0,0,2,5
aragn,0,2,0,0,0,2
prophecy,1,1,0,2,1,5
survivalism,1,0,1,1,1,4
matarlatanta,0,0,0,0,1,1
yves,0,0,0,1,0,1
daimer,1,1,0,1,1,4
meathead,1,0,0,0,0,1
bourre,1,2,0,0,1,4
biancas,1,1,0,1,1,4
laughter,3,1,2,1,3,10
mouvement,0,0,0,1,0,1
streak,1,0,0,1,0,2
amalgama,0,0,0,1,0,1
desierta,0,0,0,0,1,1
stream,1,1,0,1,1,4
performed,4,0,0,0,0,4
juoksuhaudoissa,1,0,0,1,0,2
sidney,1,0,1,1,1,4
dress,3,2,1,2,2,10
sundance,1,1,0,1,1,4
fourth,0,0,0,1,0,1
algn,1,0,1,1,1,4
begs,1,1,0,1,1,4
glissez,0,1,0,1,0,2
informa,1,0,0,1,1,3
ballroom,2,2,1,1,2,8
fascist,2,2,2,2,2,10
primeira,1,1,0,1,1,4
namorada,0,1,0,0,1,2
jaguars,1,0,1,1,0,3
birthday,1,0,0,0,0,1
liquid,2,4,2,4,1,13
rollin,3,3,1,1,1,9
arrete,0,0,0,2,0,2
fleetwood,0,0,1,0,0,1
infantes,1,0,0,0,1,2
exclusive,1,1,0,0,1,3
manera,0,0,0,0,1,1
midnight,14,11,3,11,9,48
worship,2,0,1,1,1,5
bacan,1,1,0,1,1,4
swang,0,0,0,0,1,1
subsurface,0,1,0,0,0,1
swans,0,0,0,1,0,1
whirlpool,2,2,1,2,2,9
lonely,9,4,3,5,11,32
nomads,1,0,0,1,0,2
tulip,0,0,0,0,1,1
conquer,1,0,1,1,1,4
grial,1,0,1,1,0,3
name,8,3,5,5,6,27
teri,0,0,0,1,1,2
daba,1,1,0,1,2,5
tortillard,0,0,0,1,1,2
possibilities,1,0,1,0,1,3
jalousie,1,1,0,0,1,3
entrambi,0,0,0,1,0,1
dholna,0,0,0,2,0,2
distinto,1,1,0,1,1,4
corvez,1,0,0,1,0,2
begun,3,3,2,3,3,14
obsession,3,3,1,3,3,13
sunrise,3,3,1,0,4,11
plans,1,0,0,0,1,2
pokia,1,1,1,1,1,5
factory,3,0,1,3,2,9
vincennes,1,1,1,1,1,5
notausgang,1,0,1,1,1,4
clover,1,1,0,1,1,4
theory,1,0,0,1,1,3
froufrou,0,0,0,1,1,2
satanic,1,0,0,1,0,2
adiosborron,1,0,0,0,1,2
mouvman,1,1,0,1,1,4
charme,1,1,0,1,1,4
gusta,0,0,0,1,1,2
subzero,1,0,0,0,0,1
turu,0,0,0,0,1,1
motion,5,4,0,5,5,19
turn,13,6,7,12,13,51
butterflies,1,0,1,1,1,4
place,9,6,5,8,6,34
swing,3,5,0,3,3,14
unchanging,1,0,1,0,1,3
sanchez,1,1,0,2,1,5
closers,1,0,1,0,1,3
barsanova,1,1,0,0,1,3
sevillanas,0,0,0,0,2,2
given,1,0,1,0,0,2
opus,1,0,0,1,0,2
uupeemmt,1,0,0,1,1,3
carbonate,0,0,0,1,1,2
bennington,0,1,0,0,1,2
plastic,4,4,3,6,5,22
cooling,1,1,1,1,0,4
waari,1,0,0,0,0,1
woodcarver,1,1,0,1,1,4
white,12,4,6,8,13,43
siciliano,1,0,1,0,0,2
dannys,1,1,1,1,1,5
season,2,0,0,1,1,4
alap,1,1,0,1,1,4
released,1,0,0,1,1,3
soulcrusher,1,1,1,1,1,5
shirley,1,0,0,0,1,2
immigrant,1,1,1,0,1,4
wide,2,0,2,0,2,6
sert,1,0,0,0,1,2
controlando,0,0,0,0,1,1
legacy,1,1,1,1,0,4
sera,0,0,0,0,1,1
cards,1,0,0,0,1,2
oath,2,0,0,1,0,3
searchers,0,1,0,0,1,2
hotstepper,0,0,0,2,2,4
violet,1,0,0,0,0,1
ammohostos,0,0,0,0,1,1
scarifice,0,1,0,0,1,2
quartier,0,1,0,1,0,2
mater,1,0,0,0,0,1
superman,2,0,1,1,2,6
prosperity,1,0,0,0,0,1
clamamus,1,0,1,0,0,2
ideas,2,0,1,1,1,5
nazareth,1,1,0,0,1,3
andante,3,1,0,2,1,7
armando,0,1,0,0,1,2
pardesi,0,0,0,1,1,2
betrayal,1,1,0,0,1,3
falls,4,1,3,3,1,12
bluebird,1,1,0,1,1,4
foundit,1,1,0,1,1,4
proud,2,0,1,0,1,4
hungry,1,1,0,1,1,4
chanteur,1,1,0,1,1,4
hear,11,4,4,6,6,31
catalyst,1,0,1,1,1,4
spaced,0,0,0,1,1,2
tron,1,1,0,1,0,3
perca,1,1,1,0,0,3
futurenow,1,0,1,0,0,2
recipe,1,1,1,1,1,5
spacer,1,0,1,1,1,4
spaces,1,0,0,1,0,2
hack,1,1,1,1,1,5
hace,1,0,1,0,1,3
trop,1,0,1,1,0,3
genius,2,1,2,1,1,7
piranha,1,1,1,0,1,4
crime,1,0,0,0,1,2
nadie,1,1,1,2,2,7
wood,1,1,0,1,1,4
believing,1,0,0,0,1,2
termometro,0,0,0,0,1,1
toca,0,0,0,1,1,2
vekov,1,0,0,1,0,2
raccolto,0,1,0,0,0,1
closure,1,0,0,1,0,2
aranero,1,0,0,0,0,1
doble,0,0,0,0,1,1
naked,2,2,2,0,2,8
clowns,1,0,1,0,0,2
blessure,0,1,0,1,0,2
turntable,0,0,0,1,0,1
parking,1,1,0,0,1,3
heavy,2,0,1,3,2,8
minner,0,1,0,0,0,1
encouraged,0,0,0,1,0,1
farmers,1,0,0,0,0,1
ways,6,3,2,4,4,19
amen,1,1,1,1,1,5
weapons,0,0,0,1,0,1
outside,2,2,1,0,2,7
arrival,1,1,0,1,0,3
tania,0,2,0,2,0,4
fearless,0,0,0,0,1,1
guitar,1,2,1,2,1,7
erde,1,1,0,1,1,4
como,4,3,1,4,5,17
glck,1,1,0,1,1,4
coma,0,1,0,1,1,3
cities,2,0,1,1,1,5
come,48,24,16,25,40,153
superstar,3,1,2,2,3,11
sanddollars,1,0,1,1,1,4
jericho,2,0,0,1,1,4
quiet,2,6,0,1,5,14
xstatic,1,0,1,0,1,3
railway,1,1,1,1,1,5
groundhog,1,1,1,1,0,4
color,1,2,1,2,0,6
trio,2,1,1,1,0,5
satisfaction,1,1,1,1,1,5
skeletons,1,1,1,1,1,5
runaway,1,1,1,1,1,5
turkey,1,0,1,0,0,2
lifes,2,1,2,2,1,8
peaceful,1,0,0,0,0,1
featuring,16,9,4,12,22,63
hardly,3,1,1,2,3,10
engine,1,0,0,0,0,1
direction,1,0,1,0,0,2
blessing,2,1,0,2,1,6
mariposa,1,1,0,0,0,2
valija,1,0,0,0,0,1
tiger,1,0,0,1,0,2
wcss,1,1,0,1,1,4
minister,0,1,0,0,1,2
timbaland,2,0,0,0,2,4
careful,2,2,1,1,1,7
spirit,3,3,3,7,2,18
case,1,0,1,1,1,4
myself,5,5,2,4,5,21
besame,1,0,0,1,1,3
averno,1,0,0,1,1,3
janies,1,1,1,0,1,4
arnold,1,1,0,0,0,2
sutisuti,1,1,0,1,1,4
crusader,1,0,1,1,0,3
ayudame,0,0,0,0,1,1
devereux,0,0,0,0,2,2
svengalis,1,1,1,1,1,5
telephone,1,1,0,0,0,2
numba,0,0,0,0,1,1
good,38,21,12,19,29,119
zhui,0,0,0,0,2,2
volition,1,1,1,0,1,4
mccomb,0,1,0,0,1,2
alphabet,1,0,0,0,1,2
granted,1,0,1,1,1,4
admit,1,0,0,1,0,2
bown,1,0,0,1,1,3
trip,3,1,3,3,2,12
ethiopia,1,0,0,1,1,3
manila,1,1,0,1,1,4
isla,1,0,0,1,1,3
shifty,1,0,1,1,1,4
isle,1,0,0,2,2,5
todos,0,0,0,0,1,1
week,1,0,1,0,0,2
palmas,1,1,0,1,1,4
applaud,1,0,1,0,0,2
nest,2,1,2,3,1,9
driver,2,1,1,0,1,5
drives,1,0,0,0,0,1
weed,2,1,2,1,0,6
submarines,1,1,1,1,1,5
petticoat,1,0,0,0,0,1
rocknroll,1,0,1,0,1,3
innsmouth,1,1,1,1,1,5
changing,1,0,0,0,1,2
weep,1,1,0,1,1,4
jonage,0,1,0,0,1,2
caliente,1,0,0,2,1,4
without,8,2,3,4,9,26
model,2,1,0,0,1,4
vandit,1,1,0,1,1,4
bodies,0,0,0,1,0,1
guided,1,0,0,1,0,2
evenfall,1,0,0,0,0,1
dahlback,1,0,0,0,0,1
actress,1,1,1,1,1,5
pariah,1,0,0,0,1,2
kill,9,1,1,5,5,21
satin,2,3,1,1,2,9
blow,1,1,0,1,1,4
samba,6,9,1,2,6,24
invictus,1,1,0,1,0,3
rose,6,2,1,2,6,17
shadrach,2,2,2,2,2,10
rosa,1,1,1,1,2,6
wall,1,1,0,0,1,3
lets,14,6,2,10,10,42
flashing,0,0,0,1,1,2
donizetti,0,0,0,0,2,2
ross,1,0,0,0,1,2
kingdom,5,2,2,2,5,16
kills,1,0,1,1,0,3
easily,1,0,1,1,1,4
crustaceans,1,0,0,1,1,3
motherinlaw,1,0,1,1,1,4
tanto,1,0,1,0,1,3
standstill,1,0,0,0,1,2
chiornie,1,0,0,1,0,2
irgendwann,1,0,0,1,1,3
resurrectionem,0,0,0,1,0,1
lardechoise,0,0,0,0,1,1
sanity,0,0,0,0,1,1
beothuck,1,0,1,0,0,2
eternity,2,0,2,2,1,7
joking,1,0,1,1,1,4
miel,0,1,0,0,0,1
pacific,1,1,0,1,1,4
respect,0,0,0,0,1,1
caribbean,1,0,0,1,1,3
mood,4,4,2,3,3,16
dunbar,0,0,0,0,1,1
eleanor,1,0,1,0,2,4
legal,1,0,1,0,1,3
moon,14,10,3,11,8,46
namibia,0,0,0,0,1,1
brivido,1,0,0,1,0,2
freed,1,1,0,1,1,4
tiene,3,3,1,3,3,13
poem,1,0,0,0,1,2
dicen,1,1,0,0,1,3
arrivederci,1,1,0,1,1,4
dices,0,0,0,1,1,2
venite,0,0,0,0,1,1
resurrection,2,2,2,2,1,9
improvisation,1,1,0,3,1,6
gendarme,1,0,0,1,1,3
stand,11,5,4,5,12,37
doze,2,0,1,1,1,5
cudi,1,0,0,0,1,2
amber,1,0,0,0,1,2
tribe,0,0,0,1,0,1
ladies,4,3,0,1,4,12
jian,0,0,0,0,2,2
timbuctu,0,1,1,1,0,3
allireland,1,0,0,1,0,2
worldfor,1,0,0,0,1,2
rising,3,1,3,3,2,12
gary,1,1,1,1,0,4
burton,1,0,0,0,0,1
mental,2,1,2,2,2,9
banho,1,1,0,1,0,3
backwater,1,1,0,1,1,4
there,15,10,7,9,14,55
gesagt,1,0,1,0,1,3
valley,3,1,1,1,3,9
pptes,1,0,0,1,1,3
vicente,1,1,0,1,0,3
poet,1,0,0,0,1,2
pygmies,1,0,1,1,1,4
terminus,1,0,1,1,1,4
glopes,1,1,0,1,0,3
feuer,0,0,0,1,0,1
beloki,1,1,0,1,1,4
sleazy,1,0,0,0,1,2
grass,2,1,0,2,2,7
usted,0,0,0,0,1,1
taylor,1,1,0,1,1,4
toiles,1,1,1,0,1,4
taste,3,1,1,2,2,9
feliz,2,1,1,2,1,7
intro,19,11,11,13,16,70
politics,2,1,2,2,1,8
norrskensdd,1,0,0,1,1,3
bishop,1,1,0,1,0,3
abyss,1,0,0,1,0,2
fiddles,0,1,0,0,1,2
fiddler,0,1,0,1,0,2
heather,1,0,1,1,1,4
piracy,0,0,0,0,1,1
rosen,1,1,1,1,1,5
rubber,0,0,0,1,0,1
roses,3,1,3,2,3,12
besos,2,0,1,2,2,7
frydenlund,0,1,0,1,0,2
trash,1,0,1,0,0,2
babylon,2,3,1,1,1,8
ouachita,1,0,0,0,0,1
songz,0,0,0,0,1,1
separate,1,0,0,0,0,1
finale,1,1,0,1,1,4
bobbys,1,0,1,0,1,3
bullets,1,1,0,0,1,3
booked,0,0,0,1,0,1
barcelona,1,1,0,1,1,4
curvy,1,0,1,1,1,4
calla,0,0,0,0,1,1
diss,1,0,1,1,1,4
transesdimanche,1,1,0,1,1,4
epipen,1,0,0,1,1,3
gerlander,1,0,0,1,1,3
fuego,1,0,0,1,1,3
dish,1,0,1,1,2,5
follow,3,2,1,2,3,11
everyones,2,1,0,1,2,6
glimpse,1,0,0,0,0,1
thursday,1,0,0,0,1,2
maleficia,1,0,0,0,1,2
vazo,0,0,0,0,1,1
painter,1,3,0,3,0,7
kvar,0,0,0,1,0,1
presentation,0,5,0,5,5,15
woman,35,27,11,11,19,103
sone,0,0,0,0,1,1
song,54,28,26,32,51,191
sono,2,1,0,0,2,5
sons,1,0,0,0,1,2
sony,1,1,0,1,1,4
ticket,1,0,1,0,1,3
appassionato,1,1,0,1,1,4
porgy,1,1,0,1,1,4
synths,1,1,0,1,0,3
lillie,1,0,1,0,1,3
wreverb,1,1,0,0,1,3
vibes,1,1,0,0,0,2
sergent,0,0,0,1,1,2
saxophone,1,0,0,0,0,1
lisa,1,0,0,0,0,1
escuchame,0,0,0,1,1,2
rats,2,0,2,2,0,6
design,1,0,0,1,0,2
oddisee,1,0,0,1,0,2
chega,1,1,0,1,1,4
jeremiah,1,0,0,0,1,2
ticky,1,0,0,0,1,2
what,52,30,27,30,39,178
hesitation,1,1,1,1,0,4
circumstance,1,1,1,0,1,4
rascal,1,0,0,0,0,1
anniversary,1,1,0,2,2,6
crush,1,1,0,1,0,3
version,609,256,290,291,523,1969
guns,1,1,1,0,1,4
racine,0,0,0,1,0,1
vamos,1,0,1,1,1,4
tagu,1,1,1,1,1,5
yksinisin,0,0,0,0,1,1
nene,1,1,0,0,1,3
fugue,5,0,0,5,5,15
nena,1,0,1,0,1,3
theresa,1,0,0,1,0,2
dedicado,0,0,0,0,1,1
directions,1,1,0,1,1,4
tragedy,3,1,1,2,2,9
cappella,1,1,0,1,0,3
naval,0,0,0,1,0,1
chale,1,1,1,1,1,5
matanza,1,0,1,0,1,3
agustin,1,1,1,1,1,5
members,0,0,0,1,0,1
palabras,1,0,0,0,1,2
solitude,1,0,1,0,1,3
florence,0,0,0,1,0,1
tutto,0,0,0,1,0,1
marashi,0,1,0,0,0,1
quiser,1,0,0,0,1,2
minor,5,2,0,3,3,13
flat,2,0,1,1,2,6
flaw,1,1,0,0,1,3
flav,0,0,0,0,1,1
knows,2,1,1,3,2,9
oboe,1,0,0,1,1,3
mira,0,0,0,0,1,1
floyd,1,1,0,0,0,2
stick,1,0,1,1,0,3
known,1,1,0,0,0,2
mellow,0,1,0,0,0,1
glad,2,0,2,2,3,9
verano,1,0,1,0,1,3
zeichen,0,0,0,0,1,1
ethno,1,0,1,1,1,4
eden,1,0,1,1,0,3
crossbreed,0,0,0,1,0,1
amdokwe,1,1,0,1,1,4
pero,1,1,0,1,1,4
excursion,1,0,0,1,0,2
janices,1,0,1,0,1,3
pony,1,2,0,0,2,5
erzhlt,0,1,0,1,0,2
azul,0,1,0,1,1,3
wycombe,1,0,0,1,1,3
metamorphosis,1,1,0,2,0,4
arise,0,0,0,0,1,1
pong,1,0,0,0,1,2
slarta,0,1,0,1,1,3
court,1,1,0,1,0,3
chaco,0,1,0,0,1,2
rather,1,0,0,1,1,3
breaking,4,3,2,4,5,18
cleansing,1,0,2,0,0,3
punkrock,1,0,1,0,0,2
musica,1,4,0,4,0,9
buenos,1,0,0,0,1,2
dreada,0,0,0,1,0,1
simplicity,3,0,0,3,3,9
sandwich,1,0,1,0,0,2
okay,0,0,0,1,1,2
ballade,1,0,0,0,1,2
fungus,1,0,1,1,1,4
adventure,2,2,2,3,2,11
numb,1,1,0,1,1,4
short,1,0,0,0,1,2
susan,1,0,0,0,1,2
dorma,1,0,0,1,0,2
shore,0,0,0,1,1,2
grande,2,2,0,0,2,6
shade,2,1,0,2,2,7
grandi,0,1,1,1,0,3
xuan,1,1,0,1,1,4
soldats,1,1,1,1,1,5
emmanuel,2,0,1,1,2,6
mission,3,0,0,1,3,7
chacacha,0,0,0,1,1,2
isnt,3,2,2,1,3,11
alamadalah,0,0,1,1,1,3
avenue,2,1,0,1,1,5
style,3,1,2,2,4,12
pray,4,2,1,3,1,11
praz,0,0,0,1,0,1
beyonce,1,1,0,0,1,3
abbey,1,0,1,1,1,4
parts,1,0,1,0,0,2
conformist,1,0,1,1,1,4
rette,1,1,0,1,1,4
bout,3,2,2,2,2,11
might,1,0,1,1,1,4
alter,1,1,1,1,1,5
somebody,6,4,3,5,6,24
botellas,1,0,0,1,0,2
abacua,1,1,0,1,1,4
hunter,5,3,2,2,5,17
speechless,1,0,0,1,1,3
hunted,1,1,1,1,1,5
marcus,0,0,0,0,1,1
gets,1,1,0,0,1,3
leli,1,0,1,0,0,2
disciple,1,0,1,1,1,4
inherent,1,1,0,0,0,2
mulin,0,1,0,0,0,1
flunkadelic,0,1,0,1,1,3
weight,2,0,2,1,2,7
generation,4,0,1,1,1,7
oppressed,1,0,0,0,0,1
hawaii,1,0,1,0,0,2
jakwob,0,0,0,1,1,2
decline,1,0,0,0,0,1
clandestino,1,0,0,0,1,2
lole,0,0,0,1,0,1
nuovo,1,0,1,1,1,4
disquiet,0,0,1,0,0,1
hydraulic,0,0,0,1,0,1
hill,5,4,2,5,6,22
comme,4,2,0,2,4,12
paradise,4,2,0,1,2,9
soulless,1,0,0,1,0,2
exodus,2,1,0,1,2,6
friday,1,0,1,1,0,3
forgive,0,1,0,0,0,1
denfants,1,0,1,1,1,4
teach,1,1,0,0,1,3
kyotronics,0,0,0,1,0,1
sylvester,1,0,0,1,0,2
stampede,1,0,1,1,0,3
shonoda,0,1,0,0,1,2
deja,1,0,0,0,1,2
fallen,1,0,1,0,0,2
vuelve,0,0,0,1,1,2
feed,0,0,0,1,0,1
feel,10,7,4,8,9,38
defecto,1,0,1,1,1,4
pork,1,0,1,0,0,2
fancy,0,0,0,1,0,1
feet,2,1,0,2,1,6
sympathy,2,1,0,1,1,5
notify,1,0,1,1,1,4
blank,1,1,1,1,0,4
invader,0,0,0,1,1,2
blanc,0,0,0,0,1,1
moan,0,1,0,0,0,1
story,8,5,2,4,11,30
breathless,1,0,1,1,0,3
passez,1,1,0,1,1,4
beibi,1,0,1,1,1,4
nian,1,1,0,1,1,4
storm,4,1,1,0,1,7
stora,1,0,0,0,0,1
vuelvo,1,0,1,0,1,3
headache,1,0,0,1,1,3
qbert,0,1,0,0,1,2
segue,1,0,0,0,0,1
clowngood,1,0,1,0,1,3
hotel,2,1,0,1,1,5
king,14,9,3,10,13,49
kind,8,6,4,7,9,34
double,0,0,0,1,0,1
dans,3,3,2,3,4,15
medicate,1,1,1,1,1,5
prairie,1,1,0,1,1,4
seamos,1,0,0,0,1,2
dani,1,0,1,0,1,3
dang,0,0,0,1,0,1
saxambando,0,1,0,1,0,2
dana,0,1,0,0,1,2
entellina,0,1,0,1,0,2
tongues,1,0,0,0,1,2
djemba,0,2,0,0,0,2
garfield,1,0,1,1,1,4
motindo,1,1,0,1,1,4
fiona,1,1,1,0,1,4
oriole,1,0,0,0,1,2
pieni,1,1,0,1,1,4
hopelessly,2,0,1,0,1,4
nights,5,2,3,1,4,15
port,1,0,0,1,1,3
maison,0,1,1,2,1,5
finding,0,1,0,0,0,1
needle,1,0,1,1,1,4
electric,3,2,0,4,3,12
kardinal,0,1,0,0,1,2
reach,3,0,3,3,1,10
cigarette,4,3,1,1,2,11
amar,1,0,0,2,2,5
nothing,13,8,8,9,8,46
seasons,1,2,0,1,0,4
doggin,2,1,0,0,0,3
windows,1,0,1,1,1,4
cordeiro,1,1,0,0,0,2
wichita,2,1,0,2,2,7
traditional,0,1,0,0,1,2
journeys,1,0,0,0,0,1
pennies,0,0,0,0,1,1
grandmas,0,0,0,1,1,2
fonc,1,0,0,1,1,3
jambalaya,2,0,0,1,1,4
stoned,1,1,1,0,0,3
melody,3,4,2,3,4,16
nuevo,0,0,0,0,1,1
cried,3,2,1,3,3,12
enfinsombre,1,0,0,0,1,2
jazz,3,5,0,3,4,15
intermezzo,1,0,0,1,1,3
moses,1,0,0,0,1,2
lavabo,1,0,1,1,1,4
porque,1,0,0,2,4,7
hablando,1,0,1,1,1,4
triangle,1,0,0,0,1,2
meditations,1,2,0,0,0,3
maailma,1,1,0,1,1,4
whistle,2,2,0,1,2,7
mortuum,0,0,0,0,1,1
rafaqat,0,0,1,1,1,3
budapest,1,1,0,1,1,4
percutindo,0,0,1,0,0,1
bolena,1,0,0,1,0,2
rinaldo,4,0,0,0,4,8
catharsis,1,0,0,0,0,1
orgofart,1,0,0,0,1,2
wheeling,1,1,0,1,1,4
wrote,1,0,1,1,1,4
regresas,0,1,0,0,1,2
dump,3,0,0,0,0,3
fuoco,0,1,0,0,0,1
wanderin,1,1,1,1,1,5
dumy,1,0,0,0,0,1
bare,0,0,0,1,1,2
bari,0,1,0,1,0,2
matin,1,0,1,1,1,4
einfach,1,0,0,0,0,1
romances,1,1,0,0,0,2
barn,1,0,0,1,1,3
recording,1,0,0,0,1,2
crushing,1,0,0,0,0,1
klut,1,0,0,0,0,1
klux,1,1,0,0,1,3
watchie,0,0,0,2,0,2
contrary,1,0,0,0,0,1
femmes,4,3,1,4,4,16
supposed,1,0,1,1,0,3
solo,6,4,3,5,4,22
latin,1,2,0,2,1,6
sola,0,1,0,0,0,1
atrs,1,0,1,1,1,4
prelude,3,0,2,3,2,10
lyrical,1,0,0,1,0,2
riddles,1,1,0,1,1,4
breakin,5,3,1,3,4,16
bandit,1,0,0,0,0,1
roman,1,1,0,0,0,2
became,1,0,0,1,0,2
baseball,1,1,0,0,0,2
samjho,0,0,0,1,0,1
alegria,0,1,0,0,0,1
mhle,0,0,0,1,1,2
rubbers,0,0,0,1,0,1
camio,1,0,0,1,1,3
sweet,16,9,5,12,14,56
sweep,0,0,1,0,0,1
lbas,1,0,0,1,1,3
ranchera,1,1,0,1,1,4
village,2,3,1,1,2,9
rave,1,0,0,1,1,3
ranchero,1,1,0,1,1,4
alkaholiks,0,0,0,1,0,1
akkarai,0,0,0,1,0,1
java,1,1,1,2,3,8
sehnsuchtsexpress,1,1,0,1,1,4
whos,1,0,0,0,0,1
wraparound,0,0,1,0,0,1
guitarra,0,0,0,0,1,1
nicol,1,1,1,1,1,5
pinini,1,1,1,1,0,4
woke,1,1,0,1,1,4
nehi,0,1,0,0,0,1
flight,4,2,1,2,1,10
panadera,1,0,0,0,0,1
demand,2,2,1,2,1,8
rocking,2,2,0,0,2,6
marche,1,0,0,1,1,3
stolen,2,1,0,1,2,6
acuerdo,2,1,1,1,2,7
theres,1,0,1,3,1,6
espacio,1,0,0,0,1,2
demon,1,0,1,0,1,3
demos,1,0,1,0,0,2
awakening,1,0,0,1,0,2
currents,1,1,0,1,1,4
blackwood,1,1,0,1,0,3
chestnuts,1,1,0,1,0,3
cannonballs,1,0,1,1,1,4
electrasonic,1,1,0,0,0,2
viola,1,2,0,0,1,4
daughters,1,0,0,0,1,2
higher,1,0,0,0,1,2
warum,1,0,0,1,1,3
cartridge,1,0,0,0,1,2
revolucin,1,1,0,0,1,3
arrived,1,0,1,1,1,4
birch,1,1,1,1,1,5
byal,1,1,0,0,1,3
spaceman,1,0,1,0,1,3
abilene,1,0,0,0,1,2
anybody,1,1,1,1,1,5
cheer,1,1,0,0,2,4
edge,6,3,3,1,5,18
know,32,15,14,19,28,108
sjlslig,1,0,0,1,0,2
questions,1,1,1,1,1,5
cabaret,2,1,1,2,1,7
prince,1,0,0,2,0,3
lioraras,1,1,1,1,1,5
tables,1,1,0,1,1,4
christlike,1,1,0,0,1,3
acapella,1,0,1,2,1,5
hsin,1,0,1,1,1,4
rossignol,1,1,0,0,1,3
vendor,0,1,0,0,0,1
amended,13,4,3,5,14,39
awakes,1,0,0,0,0,1
procuration,1,0,0,1,1,3
bleibt,1,1,0,1,1,4
maracaia,0,0,0,1,1,2
unlimited,2,2,2,2,2,10
sharpener,1,1,0,1,1,4
lovin,9,6,4,4,7,30
volver,1,0,0,1,1,3
awaken,1,0,1,1,1,4
socialgrupp,0,0,0,1,0,1
sencillamente,1,0,1,1,1,4
message,3,3,2,0,1,9
incidental,2,2,0,2,0,6
arthur,1,0,0,1,1,3
essential,1,0,0,0,0,1
waitin,1,1,1,1,2,6
fucking,1,0,0,0,0,1
understood,1,0,0,0,1,2
marmalade,0,1,0,0,1,2
spontanous,1,1,0,1,1,4
clown,0,0,0,1,1,2
wonderland,1,2,0,3,2,8
nachts,0,0,0,0,1,1
wanderlust,1,0,0,0,1,2
rien,4,3,2,3,4,16
lizzy,1,0,0,0,0,1
conmigoperdoname,0,0,0,0,1,1
erotas,0,0,1,0,1,2
lappi,1,0,0,0,1,2
rituals,1,0,0,0,1,2
tends,1,0,1,1,1,4
ojos,4,1,2,3,6,16
fragments,1,1,0,1,0,3
prod,2,0,0,0,2,4
anna,1,0,0,1,0,2
queremos,0,0,0,1,1,2
sheng,0,0,0,1,3,4
palmer,1,0,0,1,1,3
faute,1,0,1,1,1,4
savoir,1,1,1,1,1,5
egine,1,0,0,0,1,2
soando,0,1,0,0,0,1
nueva,1,0,0,0,1,2
decidete,1,0,0,0,1,2
qing,0,0,0,0,2,2
undertow,2,0,1,0,1,4
cranford,2,0,0,0,2,4
kabhi,0,0,0,1,0,1
violins,1,0,1,1,1,4
lifeless,1,1,0,1,0,3
militia,1,0,1,0,1,3
serenata,1,1,0,0,2,4
dialog,1,1,0,0,1,3
hatred,1,0,1,1,0,3
womens,1,1,1,1,1,5
wanna,13,7,9,9,8,46
bleeds,2,0,0,0,2,4
fantasie,1,0,0,1,1,3
johns,1,1,0,0,0,2
shed,1,1,0,0,0,2
drifter,1,1,0,1,1,4
momma,0,0,0,1,1,2
because,6,4,2,3,5,20
gavel,1,1,0,1,1,4
danote,1,0,0,1,0,2
damiti,0,1,0,0,1,2
rubor,1,1,0,1,1,4
canal,0,1,0,0,1,2
janam,0,0,1,1,0,2
bruv,1,0,1,0,0,2
cobardes,0,1,0,1,1,3
question,5,2,2,2,5,16
long,28,15,10,17,26,96
brun,0,1,0,0,0,1
alfredovioletta,1,0,0,1,0,2
summertime,1,1,0,0,1,3
todas,1,1,0,0,0,2
vienna,1,0,1,0,1,3
mountains,3,1,2,2,3,11
melodia,2,1,0,2,2,7
prez,0,1,0,1,0,2
girlfriends,1,0,1,0,1,3
junior,1,1,0,0,0,2
raising,0,0,1,0,0,1
commercialism,1,1,0,0,1,3
calles,1,1,1,1,1,5
fries,2,2,0,0,2,6
peppermint,1,1,1,1,1,5
suckin,1,0,0,1,1,3
fica,0,0,0,1,0,1
pres,1,0,1,1,1,4
sosla,1,1,0,1,1,4
fried,2,2,0,1,2,7
called,3,1,2,2,3,11
deliverance,1,0,0,0,1,2
tuman,1,0,0,1,0,2
freak,2,1,2,4,2,11
mosiah,0,0,0,0,1,1
warning,1,0,1,1,1,4
home,31,19,14,15,26,105
rainbow,12,10,4,8,10,44
garonnire,0,0,0,1,1,2
rains,0,0,1,0,0,1
peace,5,6,3,8,5,27
backs,1,1,0,1,0,3
cuenta,2,1,1,1,2,7
towers,1,0,1,0,0,2
hannikaisen,1,0,0,1,1,3
nice,5,4,3,3,4,19
mythodea,1,0,0,1,1,3
noche,2,1,1,1,1,6
missin,1,1,0,0,1,3
problems,2,1,2,3,2,10
divum,0,0,0,0,1,1
pasajera,1,0,0,1,1,3
meaning,1,0,1,1,1,4
vigil,1,0,0,0,1,2
posters,0,1,1,0,0,2
kookosphkin,1,1,0,1,1,4
remix,59,29,24,50,50,212
raketen,1,1,1,1,1,5
lead,2,0,2,1,2,7
dropsonde,1,0,1,1,0,3
sostenuto,0,0,0,0,1,1
afonsina,0,0,0,1,1,2
nasa,1,0,0,1,1,3
karma,2,1,1,1,2,7
narrative,2,0,0,0,2,4
once,2,0,0,0,2,4
mardi,2,2,0,0,2,6
resistance,2,0,1,1,2,6
alien,1,1,1,1,1,5
windy,1,0,0,0,1,2
jimi,1,0,0,0,1,2
winds,1,0,1,1,1,4
ramuka,1,1,0,1,0,3
fotia,1,0,0,0,1,2
cruiser,0,1,0,1,0,2
xxii,1,0,0,1,1,3
coloness,1,0,0,1,1,3
itll,1,0,0,1,0,2
ultraviolence,1,0,1,1,0,3
dandy,1,0,0,0,0,1
hellnd,0,0,1,0,0,1
revitalise,1,1,1,1,1,5
gina,1,1,1,1,1,5
spoon,2,0,1,2,2,7
akhm,1,0,0,0,0,1
sheds,0,1,0,1,0,2
drinking,2,2,0,1,1,6
aattelepa,1,0,0,1,1,3
zeit,1,1,1,2,1,6
pluvialus,1,0,0,1,0,2
melodies,1,0,0,0,1,2
pleas,1,0,0,0,0,1
someday,6,4,1,3,4,18
procession,1,0,0,1,1,3
tumblin,3,2,1,1,1,8
ostravaczech,1,1,1,0,1,4
fold,0,0,0,1,0,1
gaurant,0,1,1,0,0,2
traveling,1,1,0,0,0,2
reunion,2,1,0,1,2,6
acid,1,1,0,1,1,4
waiting,12,6,4,7,11,40
capitan,1,1,0,0,1,3
ammunition,1,0,0,0,1,2
lgrimas,1,0,0,0,1,2
forains,1,1,1,1,1,5
desires,1,0,0,0,1,2
kangaroo,2,0,0,1,1,4
pushing,1,0,1,0,0,2
sexo,1,0,0,0,1,2
phantoms,1,0,0,0,0,1
separation,2,0,2,2,2,8
sexy,1,1,0,1,2,5
headsprung,1,0,0,0,1,2
miser,1,0,1,0,0,2
yueh,0,1,0,0,1,2
larger,1,0,0,0,1,2
shades,0,0,1,1,0,2
leaving,1,1,0,2,0,4
headless,0,1,0,0,0,1
cokane,1,1,0,0,1,3
olivier,0,0,0,1,0,1
breeds,1,0,0,0,0,1
shovel,0,0,0,1,0,1
apple,2,1,0,0,2,5
harda,1,0,0,0,0,1
tatz,1,0,0,1,1,3
duck,1,0,1,0,1,3
dubrovnic,1,1,0,0,1,3
yannick,1,0,0,1,1,3
from,65,37,27,27,48,204
hears,1,0,0,0,0,1
escuta,0,1,0,0,0,1
quitxalla,1,0,1,1,1,4
frog,1,1,0,0,1,3
pura,1,1,0,0,1,3
staxhigh,0,1,0,0,1,2
wayne,1,0,0,0,0,1
eagles,1,1,1,0,1,4
clever,4,0,4,4,4,16
dorgue,0,1,0,1,0,2
sors,1,0,0,0,1,2
tienne,0,0,1,1,1,3
chichi,0,1,0,0,0,1
heim,1,0,0,0,0,1
taevas,1,0,0,1,0,2
porcs,1,1,0,0,1,3
women,1,0,0,1,1,3
disingenuous,1,1,0,1,0,3
evenglow,0,0,0,1,0,1
anywhere,2,0,0,1,2,5
pedagogy,1,0,0,0,0,1
proof,1,1,1,1,1,5
thirsty,2,1,2,2,1,8
cierra,0,0,0,0,1,1
raggle,1,1,0,0,1,3
faceplant,1,0,1,1,1,4
something,8,6,3,6,8,31
rape,2,0,0,0,0,2
summers,1,1,1,1,1,5
united,1,0,0,0,0,1
syndrome,1,1,1,1,1,5
guru,0,0,0,1,0,1
parlour,0,0,0,1,0,1
fortunate,2,0,1,0,2,5
prognosis,1,1,0,1,0,3
chre,1,0,0,1,1,3
bark,1,0,0,0,0,1
instead,0,1,0,0,0,1
panic,1,0,1,0,1,3
memoir,1,0,0,1,0,2
gallo,1,1,0,0,0,2
dominion,1,0,0,0,0,1
komor,1,0,1,1,1,4
psychedelia,1,0,1,1,1,4
rollercoasting,1,0,1,1,1,4
somethin,2,1,2,1,1,7
tanzen,1,1,1,1,1,5
montmartrois,1,1,0,0,1,3
soleil,1,1,0,1,1,4
light,18,7,10,14,16,65
liian,1,0,0,1,1,3
windpower,2,2,2,2,2,10
crawling,2,1,1,1,1,6
necklace,1,1,1,1,1,5
jolie,0,1,0,0,0,1
marlowe,1,0,1,1,0,3
mafu,0,1,0,0,0,1
complicate,1,0,0,0,1,2
glee,0,0,1,0,0,1
ships,1,1,1,0,1,4
nostalgia,1,0,0,1,1,3
myasorubka,1,0,0,1,0,2
primordial,1,0,0,0,0,1
choose,1,0,1,1,1,4
orange,2,0,2,2,0,6
covered,1,0,0,1,1,3
holiday,0,0,0,1,1,2
jukebox,1,1,1,1,1,5
trows,1,0,0,1,0,2
planxty,0,0,0,0,1,1
bumbling,1,1,0,1,1,4
crash,3,1,0,0,1,5
practice,1,1,0,1,1,4
emerald,1,0,1,1,1,4
seas,1,0,0,0,1,2
sinners,0,0,0,1,0,1
trad,1,0,0,1,1,3
tratre,1,0,1,1,1,4
profound,1,0,1,1,0,3
edit,16,13,11,20,15,75
youmore,1,1,0,1,1,4
trak,1,1,1,1,0,4
billy,1,1,0,0,1,3
latvia,1,1,0,0,1,3
fiddle,1,1,0,0,0,2
tras,0,1,0,0,0,1
champ,1,1,0,1,0,3
bills,0,1,0,0,0,1
trax,1,0,0,1,0,2
skank,0,0,0,1,0,1
firepower,1,1,0,1,0,3
semen,1,0,0,1,1,3
tabloid,1,1,1,0,1,4
revelator,1,1,1,1,0,4
chaos,2,1,0,2,1,6
tcale,1,1,0,1,1,4
grits,1,0,0,0,0,1
kaur,0,1,0,1,0,2
cornpone,1,1,0,1,1,4
nuit,1,0,0,1,1,3
mississippi,1,1,0,0,0,2
rakkautta,1,1,0,0,1,3
heartbreaker,1,1,0,0,1,3
york,3,4,2,2,3,14
anyhow,1,0,0,1,1,3
llorando,0,0,0,1,2,3
river,9,9,3,8,12,41
cais,1,1,0,1,0,3
spazs,1,0,0,0,1,2
conversation,0,1,0,1,2,4
poderte,0,0,0,1,0,1
adrian,1,0,0,1,0,2
cain,1,0,0,0,1,2
firehouse,1,0,0,1,1,3
echo,1,2,0,0,1,4
probation,0,1,0,0,0,1
bois,1,1,0,0,1,3
coolsville,1,1,1,1,1,5
vino,2,0,0,0,2,4
stephan,0,0,0,1,0,1
inertiatic,1,0,1,1,0,3
neira,1,1,0,1,0,3
shell,1,0,1,0,0,2
acteact,0,1,0,0,0,1
regarde,1,0,1,1,1,4
academy,2,0,2,2,0,6
salzanitos,1,0,1,0,0,2
july,2,1,0,2,2,7
holland,1,1,1,1,1,5
boring,2,0,2,1,1,6
guauqui,0,1,0,0,0,1
banjoreno,0,1,0,0,0,1
carnaval,4,4,0,0,0,8
tommy,1,0,1,1,1,4
lucium,1,0,0,0,0,1
endeka,0,0,0,0,1,1
dynamo,1,1,1,0,1,4
encore,2,2,1,2,1,8
faithkeeper,0,0,0,1,0,1
sonho,0,1,0,0,0,1
yellin,1,0,1,0,1,3
bliv,1,0,0,1,0,2
sarambeque,0,1,0,1,1,3
catholic,1,0,0,0,1,2
afraid,2,1,1,2,2,8
grustnaja,1,1,0,0,0,2
rincn,1,0,1,1,1,4
tariacuri,0,0,0,0,1,1
stormtrooper,1,0,1,0,1,3
martha,1,0,1,0,0,2
criteria,0,0,0,0,1,1
clash,2,2,2,2,2,10
centre,1,0,1,0,0,2
cracking,1,0,1,0,0,2
lidole,1,0,1,1,1,4
class,3,2,3,2,2,12
spirits,0,1,0,1,0,2
polyester,1,1,1,1,1,5
mistadobalina,1,1,1,1,1,5
pipe,2,0,2,2,0,6
oneerstes,0,1,0,0,0,1
vermes,1,1,1,1,1,5
guinea,1,1,1,1,0,4
weeny,1,0,0,1,1,3
chances,1,1,0,1,1,4
ulan,1,1,1,1,1,5
senegal,0,1,0,0,0,1
perlas,0,1,0,0,0,1
niev,1,1,0,0,1,3
fear,5,3,2,2,3,15
darkest,1,0,1,1,0,3
feat,38,27,16,35,41,157
reminisce,2,1,1,1,1,6
combo,1,0,0,1,1,3
piano,10,5,1,9,8,33
cube,0,0,1,0,0,1
workin,1,2,1,2,1,7
watching,1,1,0,1,1,4
sueo,0,2,0,1,2,5
dope,2,0,1,1,1,5
jorobadito,1,0,0,0,1,2
ones,3,2,1,1,3,10
wigue,1,1,0,1,1,4
tierra,1,0,0,1,1,3
words,6,0,1,2,4,13
burglary,1,0,0,0,0,1
chips,1,0,0,1,1,3
ghetto,2,1,1,2,3,9
heretic,2,0,1,0,1,4
mazhar,0,1,0,1,0,2
kanssain,1,0,0,1,1,3
deceived,2,1,1,1,2,7
viralo,0,1,0,1,0,2
klappert,0,0,0,1,1,2
aqualite,1,0,0,0,1,2
hymnal,0,0,1,0,1,2
uhuhuh,0,1,0,0,0,1
luminous,1,1,0,1,1,4
maries,1,0,0,0,1,2
montalvo,1,1,1,0,1,4
closer,2,1,1,1,1,6
closes,1,0,0,0,1,2
favor,1,0,1,0,0,2
viper,1,0,0,0,1,2
closed,1,0,1,1,1,4
copilot,1,0,1,0,1,3
junko,1,0,0,0,0,1
cola,1,0,1,1,1,4
pants,3,0,1,1,2,7
fagioli,1,0,0,1,1,3
cello,1,1,0,0,0,2
opening,2,0,0,1,0,3
schitzo,1,0,1,1,1,4
lagda,0,0,0,1,0,1
takeover,1,0,0,0,0,1
montmartre,0,0,0,0,1,1
piece,4,2,2,1,3,12
lifeboat,1,1,1,0,0,3
april,2,0,1,1,2,6
diehard,1,0,0,0,0,1
borrare,0,0,0,0,1,1
worldll,0,0,1,0,1,2
wala,0,0,1,1,0,2
tunisia,0,1,0,0,0,1
operawishing,1,0,0,0,1,2
makin,2,2,1,0,1,6
walk,12,10,5,8,10,45
exiliado,1,0,1,1,1,4
table,3,1,1,0,1,6
amigo,2,1,0,0,4,7
golfshirt,1,0,1,1,1,4
boatman,1,1,0,1,1,4
reindeer,1,2,0,2,2,7
mike,1,2,0,0,1,4
skinhead,1,0,0,0,1,2
msicas,1,1,0,0,0,2
crappy,1,0,1,1,1,4
overture,2,2,2,2,1,9
desperados,0,1,0,1,0,2
present,2,0,0,2,0,4
sanctify,1,1,1,1,1,5
choices,0,0,0,0,1,1
will,35,17,15,20,37,124
kommando,1,0,1,1,1,4
headlock,0,0,0,1,1,2
wild,11,7,4,3,8,33
madeleine,1,1,0,1,1,4
happened,1,1,0,0,1,3
bolero,1,1,1,1,1,5
buzzards,1,1,1,1,1,5
boite,1,0,1,1,0,3
duas,0,1,0,0,0,1
thus,0,0,0,1,1,2
konjunkturpaket,1,0,1,1,1,4
guajiro,0,1,0,0,0,1
education,1,1,1,1,1,5
radiation,1,0,1,0,0,2
cross,6,2,3,2,6,19
eschaton,2,0,1,1,1,5
units,1,0,0,1,0,2
lobotomy,1,0,1,1,0,3
hlvenee,1,0,1,1,1,4
parthenon,1,0,1,1,1,4
slave,3,2,1,1,3,10
outcast,1,1,0,1,1,4
beast,4,2,1,1,2,10
cheshire,1,0,0,0,0,1
valerie,2,1,0,0,1,4
tynn,1,0,0,1,1,3
fighting,3,0,1,0,1,5
kuolema,1,0,0,0,1,2
halb,0,0,0,0,1,1
degarmo,1,0,0,0,0,1
english,3,0,2,2,3,10
breaker,1,0,0,1,0,2
chataigniers,0,1,0,0,1,2
rocker,2,0,0,1,1,4
fausse,0,1,0,0,1,2
plombier,0,0,0,1,1,2
rocket,2,2,1,2,2,9
cries,1,1,0,1,0,3
batteries,1,0,1,1,1,4
rachels,1,1,1,1,1,5
herval,0,1,0,0,0,1
fishing,1,1,0,0,1,3
happiness,1,0,1,1,1,4
pendulum,1,0,0,0,1,2
hoppa,1,0,0,1,0,2
supply,1,1,0,1,0,3
smith,1,1,1,0,0,3
dartiste,1,0,0,0,1,2
book,2,2,1,2,2,9
boom,1,0,0,2,1,4
preso,0,1,0,1,0,2
myth,2,1,2,1,2,8
interrogation,0,0,1,1,0,2
darkside,1,1,0,1,1,4
temperedclavier,1,0,0,1,0,2
irreemplazable,1,1,0,0,1,3
megatrend,1,1,0,0,1,3
posttoxic,1,0,0,1,1,3
loses,1,1,0,1,1,4
vortex,1,1,0,1,0,3
tennessee,2,0,2,1,2,7
cutler,1,0,0,1,1,3
viimeiset,1,0,1,1,1,4
iskorosten,1,0,1,0,1,3
wonders,0,0,0,1,0,1
amores,1,1,0,2,3,7
tumble,1,1,0,1,1,4
bequeth,0,0,1,0,1,2
scared,3,2,0,0,3,8
searching,1,1,1,0,1,4
growth,1,0,1,1,0,3
beguine,0,0,0,0,1,1
star,9,6,4,8,8,35
empire,4,3,0,1,2,10
amoren,1,0,0,0,1,2
jeremy,1,1,1,1,0,4
nedle,1,0,1,0,0,2
operation,0,0,0,1,1,2
earrings,1,0,0,0,0,1
leader,2,1,1,0,2,6
ripped,1,0,0,1,1,3
slut,0,0,1,0,1,2
ability,1,0,0,0,1,2
ripper,1,0,1,1,1,4
slum,1,0,0,0,0,1
taggle,1,1,0,0,1,3
supermassive,1,1,1,1,1,5
throne,1,0,1,1,0,3
tyttret,1,0,0,1,0,2
getting,1,1,1,1,0,4
universe,4,3,3,2,4,16
asha,1,1,0,1,1,4
raro,1,1,0,0,0,2
ressusciteront,0,0,0,1,0,1
epiphany,1,0,1,0,1,3
sweat,2,1,2,2,1,8
subida,0,0,0,0,1,1
kanaka,0,0,0,1,1,2
emperor,1,1,1,1,1,5
togshan,0,1,0,1,0,2
weather,5,2,1,0,4,12
promise,1,0,0,1,1,3
invidio,0,0,0,1,0,1
registration,0,2,0,0,0,2
colombine,1,1,0,0,1,3
roadhead,1,0,1,1,1,4
platoon,2,1,0,1,1,5
grapevine,1,0,1,0,1,3
munster,0,0,0,1,0,1
kidding,1,0,1,1,1,4
adelante,0,0,0,1,1,2
shang,0,0,0,0,3,3
bitches,1,0,0,1,0,2
mutter,1,1,0,1,1,4
volume,2,2,0,1,2,7
nassau,1,0,1,0,1,3
made,9,4,4,6,4,27
frukos,0,1,0,1,0,2
mundharmonika,1,1,0,0,1,3
record,3,2,3,1,3,12
below,1,1,1,1,1,5
tema,2,1,0,1,1,5
block,2,0,2,0,0,4
jenny,3,2,2,3,3,13
braucht,1,0,1,1,1,4
kingsize,1,1,0,1,1,4
gleniffer,1,0,0,0,0,1
goodness,0,0,0,1,1,2
brauche,1,0,0,1,1,3
entrada,0,0,0,0,1,1
naming,1,0,1,0,0,2
tranceplant,2,0,0,2,2,6
branco,0,0,0,1,0,1
roars,1,0,0,0,1,2
other,10,2,2,4,5,23
pretinha,1,1,0,1,0,3
sick,1,0,1,2,2,6
coffees,1,0,1,0,1,3
branca,1,1,0,1,0,3
alobi,0,0,1,0,0,1
dhol,0,0,0,2,1,3
junk,1,0,1,1,1,4
juno,1,0,1,1,1,4
airtos,1,1,0,1,1,4
june,2,1,2,2,1,8
jung,1,0,0,1,1,3
apoliome,1,0,0,1,1,3
kinda,1,2,1,1,1,6
rhapsody,1,2,0,1,1,5
spinward,1,1,0,0,0,2
cliff,1,0,0,0,0,1
rotting,1,0,1,0,0,2
bwoy,0,0,0,1,0,1
pode,1,1,1,1,1,5
batallon,0,1,0,0,0,1
lchelns,0,0,0,0,1,1
heidi,0,1,0,0,1,2
allein,1,0,0,1,1,3
aziatic,1,0,0,0,0,1
raining,3,3,1,2,2,11
ramne,1,1,0,1,1,4
tlfm,1,1,0,1,1,4
yellow,5,1,4,5,4,19
narcotic,1,0,1,1,0,3
four,6,3,1,4,4,18
woods,1,1,0,1,2,5
spiders,1,1,0,0,0,2
mirage,0,0,0,1,0,1
marching,2,1,0,2,0,5
otra,2,0,0,1,2,5
dustland,1,0,1,0,1,3
arriesgarnos,0,0,0,0,1,1
lore,0,0,0,0,1,1
lord,9,10,2,6,11,38
swivel,1,1,0,1,1,4
callin,1,0,0,0,0,1
freeword,1,0,0,0,0,1
oceans,1,1,1,1,0,4
travellin,2,1,1,0,1,5
oceano,1,0,1,0,1,3
screaming,2,0,1,0,0,3
basics,1,0,1,1,1,4
decima,0,1,0,0,0,1
jihad,1,0,0,0,0,1
koronoko,1,1,1,1,1,5
oooh,0,1,0,0,0,1
pivo,1,0,0,1,0,2
merengue,0,0,0,0,1,1
caramelo,1,0,0,1,0,2
tired,3,1,0,1,0,5
garraud,0,1,0,1,1,3
hanging,1,0,0,0,1,2
second,6,5,4,3,6,24
glassi,1,1,1,1,1,5
shuile,0,0,0,1,1,2
tirez,1,1,1,1,1,5
soave,1,0,0,1,0,2
dynamit,0,0,0,1,1,2
thunder,2,1,0,0,2,5
boogie,4,6,0,1,1,12
fingers,3,2,2,3,3,13
roadhouse,1,1,0,0,1,3
essaywhuman,0,1,0,1,1,3
hero,3,0,1,0,2,6
schmerzensschreie,1,0,0,0,0,1
eunice,1,0,0,0,1,2
here,27,12,10,12,22,83
chinz,1,1,1,1,1,5
herz,3,1,0,3,4,11
china,1,2,0,1,2,6
megalodon,1,1,0,0,0,2
gayee,0,0,0,1,0,1
kids,3,1,1,1,4,10
merrygoround,2,2,2,0,1,7
nomades,1,1,0,1,1,4
natures,1,1,0,1,1,4
juras,1,0,0,0,1,2
rebel,2,2,0,0,2,6
golden,5,3,1,5,4,18
roadrunner,1,0,0,0,1,2
kenourgia,1,0,0,0,1,2
slivery,1,0,0,0,0,1
ressuscits,0,1,0,1,0,2
nessum,1,0,0,1,0,2
spoke,1,1,0,0,1,3
cannibal,1,0,0,0,1,2
symphony,1,1,1,1,2,6
music,25,17,15,21,19,97
mystic,1,1,1,1,1,5
strike,1,1,1,1,1,5
until,5,4,3,4,5,21
imparable,1,0,0,0,1,2
playboy,1,1,0,1,1,4
holy,2,1,0,1,2,6
relax,0,0,0,1,1,2
brings,1,0,1,0,0,2
gedroomd,1,1,1,0,1,4
pasta,1,0,0,1,1,3
machinenfunk,1,0,0,1,0,2
hurt,1,2,1,0,2,6
glass,1,1,0,0,0,2
holi,1,0,1,2,1,5
hole,6,4,3,4,5,22
hold,20,8,7,15,19,69
doppelgnger,1,0,1,1,0,3
hola,1,1,0,1,0,3
circumstances,1,0,0,0,0,1
evigne,1,1,0,1,1,4
locker,1,1,1,1,1,5
sweeter,1,1,1,0,1,4
matilda,1,2,0,1,3,7
wang,0,2,0,1,4,7
dyks,1,1,0,1,1,4
titanium,1,0,0,1,1,3
caution,1,1,0,1,1,4
want,21,10,12,20,23,86
salamanders,1,1,0,0,1,3
somebodys,3,0,0,0,1,4
absolute,2,0,1,1,1,5
cielo,1,0,1,1,0,3
travel,4,0,1,2,2,9
seuraavassa,1,0,1,1,1,4
damage,1,1,1,1,1,5
machine,7,0,3,5,6,21
louisville,1,0,0,0,1,2
machina,1,1,1,1,1,5
eimsbush,0,0,0,1,0,1
cadence,1,1,0,1,0,3
grazon,1,1,1,1,1,5
moritat,1,1,0,0,1,3
beauty,8,1,2,6,7,24
wilakuy,0,0,0,0,1,1
stravinsky,0,0,0,0,2,2
ryders,1,0,0,0,1,2
shores,1,0,0,0,1,2
wrong,7,3,2,2,6,20
destined,1,0,0,0,0,1
ouroboros,1,0,1,0,0,2
scourge,1,0,1,1,1,4
buzzs,0,0,1,0,0,1
baggage,1,1,1,1,1,5
keeps,1,1,1,1,2,6
wing,2,1,0,1,2,6
wind,7,9,3,7,8,34
wine,1,0,1,2,2,6
peux,1,1,1,1,1,5
boire,0,0,0,1,1,2
peut,0,0,0,1,0,1
dejes,0,1,0,0,0,1
virgen,0,1,0,1,0,2
dreamer,1,1,0,1,0,3
cumpagno,1,0,0,1,1,3
ruta,1,0,0,0,1,2
survivors,1,0,1,1,0,3
hidden,5,2,1,4,3,15
glorify,1,0,1,0,1,3
thrones,0,0,1,0,0,1
biding,1,0,1,0,1,3
jamalo,1,1,1,1,1,5
sixteen,1,1,1,1,0,4
silver,6,3,1,5,5,20
rumour,1,1,1,1,1,5
disconnection,1,0,0,0,1,2
eoghain,1,1,0,1,1,4
chinoiserie,0,1,0,1,0,2
spider,1,0,1,1,1,4
solution,1,0,0,0,1,2
contracting,1,1,1,1,1,5
cathedral,1,0,0,1,1,3
blinded,1,1,1,1,1,5
whip,2,0,1,3,1,7
romntico,0,1,0,0,0,1
toute,1,0,0,0,0,1
urbans,0,0,0,0,1,1
outburst,1,0,1,0,0,2
clarence,1,1,0,0,1,3
knig,1,0,0,1,1,3
sensory,1,0,1,1,1,4
efialtis,1,0,0,0,1,2
estimate,1,1,0,0,0,2
cornerstone,1,1,0,1,1,4
bateu,1,1,0,1,0,3
iceman,1,1,0,0,1,3
villes,1,0,0,0,1,2
gouldagnes,0,1,0,0,1,2
chitlins,1,0,0,0,0,1
holbrook,1,0,0,0,1,2
veggie,1,1,1,1,1,5
channels,0,0,0,1,1,2
wash,2,2,1,2,2,9
dpaves,1,1,0,0,0,2
sensazioni,0,1,0,0,0,1
windmills,1,2,0,2,1,6
lectro,1,1,0,0,1,3
reuben,1,1,0,0,1,3
tango,5,2,1,3,5,16
stack,0,0,0,0,1,1
reginella,1,0,0,0,0,1
master,5,4,2,4,2,17
pierrade,1,1,1,1,1,5
scandalon,0,0,0,0,1,1
legs,1,0,1,1,1,4
genesis,2,0,1,1,0,4
listen,1,1,0,1,1,4
summerfish,0,0,0,1,1,2
juventud,1,1,0,0,1,3
supertouchshitfit,1,0,0,0,0,1
crawl,1,1,1,1,1,5
amsterdamaged,1,0,1,0,0,2
icicle,1,0,1,1,1,4
mercato,0,0,0,0,1,1
coward,1,0,0,0,0,1
tree,5,2,1,2,6,16
yodelling,1,1,0,1,1,4
nations,0,0,0,1,0,1
project,1,1,1,1,1,5
ahmet,1,1,0,0,1,3
tres,1,1,0,1,0,3
feeling,4,4,2,3,3,16
heyya,0,0,0,2,2,4
este,0,0,0,1,1,2
esta,1,1,1,0,1,4
boston,3,2,1,0,2,8
sparnuotoji,1,0,0,0,0,1
juneau,1,0,0,0,0,1
onono,1,1,1,1,1,5
bawlz,1,0,1,1,1,4
novakane,2,0,0,0,0,2
soaked,1,0,1,0,0,2
dixime,1,1,0,1,1,4
himlen,0,1,0,0,0,1
matriarch,1,1,0,1,0,3
shall,0,1,0,0,0,1
doin,2,2,0,2,1,7
object,1,2,1,1,2,7
mouth,2,1,0,1,1,5
letter,3,4,0,2,3,12
dois,1,0,0,0,0,1
thriller,1,0,1,1,1,4
singer,1,1,1,1,1,5
episode,1,1,0,1,1,4
pome,1,1,1,1,1,5
matins,1,1,0,1,1,4
camp,0,1,0,1,1,3
cumbia,0,0,0,0,1,1
tech,0,0,1,0,0,1
bartholdis,0,1,0,1,0,2
mensaje,1,1,0,0,0,2
scream,1,1,1,2,1,6
came,8,4,3,5,6,26
marvel,1,1,1,1,1,5
silber,1,0,0,1,0,2
bomb,4,1,3,3,3,14
bonnie,2,1,1,2,2,8
ulcer,1,0,0,1,1,3
pris,1,1,0,0,1,3
rusticana,1,1,1,1,1,5
orleans,2,3,0,2,2,9
teasin,1,1,2,1,0,5
busy,0,0,0,1,0,1
doilea,1,0,0,1,0,2
louise,3,2,1,1,3,10
telegrama,1,1,1,1,1,5
cupid,1,0,1,0,0,2
bush,1,1,0,1,1,4
bliss,1,1,0,2,1,5
rich,1,0,0,0,1,2
rice,2,0,1,1,2,6
kablammin,1,1,1,1,1,5
plate,1,0,1,1,1,4
rmer,1,1,0,1,1,4
plati,1,0,1,1,1,4
terrors,1,0,0,0,0,1
pocket,3,0,2,1,2,8
danse,1,1,1,1,1,5
kurrajong,1,1,0,1,0,3
jaguar,0,1,0,1,1,3
saylarvee,1,0,1,0,1,3
release,2,0,0,2,1,5
fait,0,0,0,1,0,1
alsina,1,0,0,1,0,2
bagad,1,0,1,1,1,4
beso,1,1,0,1,1,4
fair,4,2,0,1,2,9
melodioso,0,0,0,1,0,1
goodnight,2,1,1,1,1,6
fail,1,0,0,0,1,2
hammer,3,0,2,0,4,9
best,7,1,0,4,5,17
sombrero,1,1,0,0,1,3
sista,1,1,1,1,1,5
blancas,0,1,0,0,0,1
wage,1,0,1,1,1,4
nature,2,2,2,1,2,9
zavelow,1,0,1,0,1,3
defiance,1,0,1,1,0,3
carbon,0,1,0,0,0,1
roller,1,0,0,1,1,3
drei,0,0,0,0,2,2
country,6,3,1,2,5,17
questo,1,1,0,2,1,5
lookin,2,2,1,2,2,9
barchetta,1,1,0,1,0,3
salario,0,0,1,1,0,2
gopher,1,1,1,1,1,5
gypsies,1,0,0,0,1,2
canyon,1,1,0,2,0,4
thoneicks,0,0,1,1,1,3
camisa,1,1,0,0,1,3
humming,1,1,0,0,1,3
niyi,1,0,1,1,0,3
matti,1,0,0,1,1,3
union,1,0,0,0,1,2
savin,1,0,1,0,1,3
much,13,6,7,8,11,45
menutha,1,0,0,1,1,3
stadium,1,1,1,1,1,5
privilege,3,0,0,0,0,3
life,41,17,15,25,32,130
electrocution,1,1,1,1,1,5
moneyg,1,0,0,1,1,3
spit,1,0,1,0,0,2
cuna,1,0,1,0,0,2
worker,1,1,1,1,1,5
wish,10,3,6,6,9,34
dave,2,1,1,2,2,8
lift,1,0,1,1,0,3
cheveux,0,0,0,0,1,1
chile,3,2,0,1,1,7
child,6,4,4,8,5,27
spin,2,0,1,1,1,5
wildcat,1,1,0,0,1,3
lurkin,0,0,0,0,1,1
volveras,0,0,0,1,1,2
player,1,1,0,2,1,5
celos,0,0,0,0,1,1
judys,0,1,0,0,0,1
madonna,1,0,1,1,0,3
ogni,1,1,1,1,1,5
pawnshop,1,0,0,0,1,2
portobello,0,1,0,0,0,1
things,10,10,3,9,12,44
split,1,0,1,2,1,5
drugam,0,1,0,0,0,1
agapas,1,0,0,0,1,2
electro,2,1,1,2,2,8
junge,1,1,0,1,1,4
european,1,0,0,1,1,3
gabry,1,1,1,1,1,5
memoria,0,1,0,1,0,2
marches,1,1,0,0,0,2
haggard,1,0,0,0,0,1
tune,1,0,1,0,0,2
charon,1,0,1,0,0,2
acoustics,1,1,1,1,1,5
poobah,1,1,1,0,0,3
eagle,0,0,1,0,0,1
melodica,0,0,0,0,1,1
dikos,1,0,0,1,1,3
autobahn,1,0,0,1,1,3
mopao,1,1,1,1,1,5
denk,0,0,0,0,1,1
givin,1,1,1,0,1,4
quasar,1,1,0,1,1,4
sleepy,2,2,1,2,2,9
praieiro,0,1,0,1,0,2
birmingham,2,0,0,2,2,6
trong,1,1,0,1,1,4
ease,1,0,1,1,1,4
topical,1,0,0,0,1,2
sofrimento,0,1,0,1,1,3
easy,8,3,3,2,6,22
prison,1,1,1,1,1,5
nelly,1,0,0,0,1,2
east,0,4,2,4,0,10
quune,1,0,1,1,0,3
wiht,1,0,0,1,1,3
shadow,3,1,0,0,2,6
depressionista,1,0,0,0,0,1
sleuthing,1,1,0,0,1,3
bridgehouse,1,0,0,0,0,1
bobby,1,0,0,0,0,1
stepn,1,1,1,1,0,4
complexe,0,0,1,1,0,2
steps,1,1,0,1,2,5
prologue,1,1,0,0,1,3
sebastian,0,0,1,0,0,1
surf,3,1,2,3,1,10
right,13,7,4,8,11,43
creek,1,1,1,1,0,4
crowd,1,1,1,1,1,5
people,18,9,6,19,18,70
teppo,1,0,0,1,1,3
warbox,1,1,0,0,1,3
crown,1,1,0,1,0,3
bereit,1,0,1,1,0,3
trombone,2,2,2,0,0,6
creep,1,1,1,1,1,5
snakebit,1,0,0,0,1,2
bottom,6,3,2,3,4,18
marseilles,1,0,1,1,0,3
lluvias,0,1,0,1,0,2
pestilence,1,0,0,0,0,1
losing,6,3,2,2,7,20
chailleach,0,0,0,1,0,1
valium,1,1,0,1,0,3
spaceships,1,0,0,1,1,3
filipino,1,1,0,0,1,3
walrus,1,1,1,1,1,5
dollars,1,0,0,1,0,2
oneness,1,1,1,1,0,4
nirai,1,0,0,0,0,1
nixon,1,1,1,0,1,4
raised,1,1,0,1,1,4
marshall,1,0,0,1,1,3
honeymoon,1,1,0,0,1,3
thankful,1,0,1,0,1,3
inhume,1,0,1,0,0,2
mambo,6,8,0,4,8,26
wrap,1,0,0,1,0,2
support,0,0,0,1,0,1
constantly,2,0,2,0,2,6
jetstream,1,0,0,1,1,3
nova,2,1,1,2,1,7
width,1,1,0,1,1,4
spring,1,1,1,1,0,4
jane,1,0,1,2,1,5
happy,13,6,4,7,13,43
forming,1,1,1,1,0,4
tigers,2,1,1,1,1,6
back,37,21,14,30,29,131
ltimo,0,2,0,0,0,2
verde,1,1,1,1,0,4
verdi,1,0,0,1,0,2
canbales,1,0,0,0,1,2
inside,6,1,4,1,6,18
confessin,1,0,0,0,1,2
peso,1,1,1,0,0,3
mighty,2,2,1,2,2,9
ormhxan,1,0,0,1,1,3
rerub,1,0,0,1,1,3
juvenile,1,0,0,0,1,2
later,1,1,1,0,0,3
disgrace,1,0,1,1,0,3
gemini,1,0,0,1,1,3
jocastae,0,0,0,0,1,1
kandiyohi,1,0,1,0,1,3
telepathyted,1,0,0,0,0,1
floor,3,2,0,4,3,12
republic,1,1,0,2,1,5
sunset,1,1,1,1,2,6
roll,12,3,5,10,10,40
rolo,1,1,0,1,1,4
reggae,6,6,4,5,1,22
aroundcomes,1,1,0,0,1,3
palms,1,0,1,1,1,4
agnus,1,0,1,0,1,3
devon,1,1,0,1,1,4
intent,1,0,0,1,0,2
chiuse,1,0,0,1,0,2
rolling,1,0,1,3,1,6
puss,0,1,0,0,0,1
cootchie,1,0,0,1,0,2
toktok,1,0,1,1,1,4
lingan,1,1,0,1,1,4
push,2,2,1,4,4,13
cincinnati,1,0,0,0,1,2
chain,2,1,1,1,1,6
maldito,0,0,0,1,0,1
chair,3,1,2,0,2,8
venice,1,1,1,0,1,4
dimelo,0,0,0,0,1,1
decir,0,0,0,1,2,3
himalaya,0,1,0,0,0,1
chokechain,1,0,1,1,1,4
exogenesis,1,1,1,1,1,5
dinicolo,1,0,0,1,0,2
llegaste,0,0,0,1,0,1
mouri,1,0,0,0,1,2
minuto,1,1,0,0,1,3
stays,1,0,1,0,1,3
jeru,0,1,0,0,0,1
locked,2,2,2,0,2,8
minute,1,1,1,1,0,4
cintura,1,1,0,1,1,4
knockin,1,0,0,1,1,3
solver,1,0,1,0,0,2
tear,3,4,3,4,3,17
maha,0,0,0,1,0,1
leave,3,2,3,2,4,14
stockade,1,1,0,0,0,2
team,1,1,0,0,0,2
karottensaft,1,0,1,1,0,3
spiritual,1,1,1,1,1,5
attic,2,0,1,2,2,7
cheree,0,1,0,1,1,3
boca,1,2,0,1,1,5
sign,1,1,2,1,1,6
droit,1,0,1,1,1,4
pienso,1,0,0,0,1,2
crescent,1,0,1,1,1,4
corazon,3,1,0,0,4,8
maschera,1,0,0,1,0,2
chimichanga,1,0,1,1,1,4
vengo,1,0,0,0,1,2
freaks,1,0,1,1,1,4
falling,9,8,5,7,8,37
mela,0,0,1,1,0,2
freaky,1,2,1,1,1,6
mele,1,1,1,1,1,5
vankina,1,0,0,1,1,3
honour,0,1,0,1,0,2
funeral,1,0,1,1,1,4
lange,0,1,0,1,0,2
understanding,0,0,0,1,1,2
alone,16,8,10,9,11,54
along,4,2,0,3,5,14
viaje,1,0,0,1,1,3
benson,0,0,0,1,1,2
terrence,1,1,0,0,1,3
cette,1,0,0,0,0,1
brazilian,0,2,0,0,0,2
jammin,1,1,1,1,1,5
studies,0,0,0,2,0,2
love,224,137,97,156,213,827
roorasty,1,0,0,0,0,1
mnchengladbach,1,0,0,1,1,3
bloody,2,1,0,1,1,5
fake,2,1,2,1,2,8
mihodina,1,1,0,1,1,4
bended,0,0,0,0,1,1
working,1,1,0,0,1,3
homesick,1,1,1,1,1,5
wicker,1,0,1,0,1,3
angry,2,1,2,0,1,6
fortway,1,0,1,1,1,4
charlies,0,0,0,0,1,1
wondering,1,1,0,2,1,5
wicked,2,1,1,0,2,6
marbles,1,1,1,0,0,3
claus,3,3,0,2,2,10
reprise,7,4,2,3,6,22
oregon,1,1,1,1,1,5
everywhere,2,0,2,1,2,7
riders,0,1,0,1,0,2
nastrond,1,0,0,1,0,2
originally,5,0,1,0,0,6
pretend,1,0,0,0,1,2
believer,0,0,0,1,0,1
believes,1,0,1,0,1,3
zhan,0,0,0,0,1,1
following,0,0,0,0,1,1
tuviera,1,0,1,0,0,2
ammonite,1,0,1,1,0,3
fingevo,1,0,0,0,1,2
profecias,1,0,1,1,1,4
graduation,1,0,1,0,1,3
allowed,1,0,0,0,0,1
goofus,0,1,0,1,1,3
ngai,0,1,0,0,0,1
savoy,0,1,0,1,1,3
winter,3,3,4,3,3,16
helden,1,1,0,0,1,3
coyotes,1,1,1,0,1,4
kenourgios,0,0,1,0,1,2
immune,1,0,1,1,0,3
elephant,1,0,1,0,0,2
gayas,1,1,1,0,1,4
snaps,1,1,0,0,0,2
nell,1,1,0,1,1,4
laundry,1,0,0,0,1,2
spot,2,2,1,2,2,9
date,4,3,2,3,4,16
such,1,0,2,1,0,4
suck,2,1,0,1,2,6
revealed,0,0,0,1,1,2
natural,2,3,0,2,2,9
belial,1,0,0,0,0,1
truck,1,0,0,1,1,3
wolves,1,0,1,1,2,5
dreamland,1,0,1,1,1,4
blowup,1,1,1,1,1,5
fencibles,0,1,0,1,1,3
pettenami,0,1,0,0,1,2
kong,2,1,1,2,2,8
course,1,0,0,0,0,1
encantadora,0,1,0,0,0,1
kanye,1,3,0,0,1,5
auguri,1,1,0,1,1,4
dropoff,1,0,1,0,0,2
tule,2,0,1,2,2,7
garbage,2,1,0,1,1,5
troubles,2,1,1,1,1,6
guarare,2,2,0,2,2,8
attraction,0,0,1,1,0,2
thump,0,0,0,1,0,1
limbo,1,0,0,0,1,2
smarter,1,1,0,0,1,3
feelin,3,1,1,3,3,11
reckoning,1,0,1,1,0,3
twilight,1,0,0,1,1,3
cachito,1,0,0,0,1,2
hickory,1,1,0,0,1,3
ladysmith,1,1,0,0,1,3
caminar,1,0,0,0,1,2
quarter,3,1,1,2,0,7
quartet,3,1,0,2,0,6
sunriseprayerjoysunset,0,0,0,1,0,1
turtle,1,1,0,1,0,3
square,1,3,1,0,1,6
revised,1,1,0,0,1,3
concertino,1,1,1,0,0,3
remembrance,1,0,0,0,1,2
container,1,1,1,1,1,5
sachmagehtsnoch,1,0,1,1,1,4
pieuvre,1,0,0,1,1,3
facedown,1,1,1,0,1,4
huevos,1,0,0,0,1,2
poema,1,2,0,1,2,6
allstar,1,1,1,1,1,5
plea,1,0,0,1,0,2
seventy,1,0,0,0,1,2
brasil,1,2,0,1,1,5
artistes,1,0,0,1,1,3
punk,3,0,1,1,1,6
dunns,0,0,1,1,0,2
horas,1,0,0,1,2,4
rompan,1,0,0,1,0,2
expolodera,0,0,0,1,1,2
spoken,4,0,2,0,2,8
potter,0,0,0,2,0,2
mucho,1,0,0,1,1,3
spanish,5,3,2,5,3,18
geheimrezept,1,0,1,1,1,4
open,6,3,4,4,4,21
lamour,3,3,0,3,4,13
city,12,6,5,8,8,39
boulevard,0,1,0,1,0,2
bite,2,0,1,2,3,8
guadalupe,1,0,0,0,1,2
realization,1,1,0,1,0,3
streetlight,1,0,0,0,0,1
boppin,1,1,0,0,0,2
southbound,1,1,0,1,1,4
boyfriend,2,0,2,1,1,6
douleur,1,0,0,0,1,2
folly,2,0,0,2,1,5
future,5,0,4,6,3,18
gravedom,1,0,0,1,0,2
sophie,1,1,1,0,1,4
nicer,0,0,0,0,1,1
turned,1,0,1,0,1,3
argument,0,1,0,1,1,3
alley,2,1,0,0,0,3
tastes,1,0,1,1,0,3
contara,1,1,0,0,1,3
horsepower,1,0,0,0,1,2
erinnerung,1,0,1,1,1,4
azucenas,0,1,0,0,0,1
mahafinaritra,1,1,0,1,1,4
wink,1,1,1,1,1,5
warriors,2,0,0,0,1,3
somethings,1,0,0,0,1,2
fertig,0,0,0,1,0,1
note,1,1,0,1,1,4
perdre,2,0,1,1,1,5
nota,1,1,0,0,0,2
take,40,21,16,20,26,123
destroy,4,1,3,2,2,12
blinding,1,0,0,0,0,1
butterfly,1,1,0,0,1,3
buffer,0,1,0,1,1,3
knew,1,0,0,0,3,4
knee,0,0,0,0,2,2
slonie,1,0,1,1,1,4
drive,7,2,3,3,4,19
badd,1,0,1,1,1,4
reinert,1,1,0,1,0,3
dolor,0,1,0,0,1,2
eeshwar,0,1,0,1,0,2
salt,0,0,0,1,0,1
stimulator,0,0,0,1,1,2
olha,0,1,0,0,1,2
saintetrinit,0,1,0,1,0,2
sinclar,1,0,0,0,1,2
peaches,1,1,1,1,1,5
boyz,0,0,0,1,0,1
bright,0,0,0,1,0,1
bitesize,1,1,1,1,1,5
slow,6,4,3,5,3,21
unkind,1,1,1,1,1,5
kalander,0,0,0,0,1,1
cloak,0,0,0,1,0,1
tears,6,5,2,3,7,23
going,17,13,8,10,16,64
actin,1,0,0,0,1,2
cerilene,1,0,1,1,1,4
nikolicaca,0,0,0,0,1,1
robe,1,0,1,1,1,4
caroline,2,1,0,1,2,6
remastered,33,12,15,16,26,102
beatles,0,0,0,0,1,1
wailin,1,1,0,1,1,4
siempre,2,1,0,0,1,4
monde,2,1,1,1,0,5
mondo,1,1,0,1,1,4
prime,0,1,0,0,1,2
phantasmagoria,1,0,1,1,0,3
bomba,2,2,0,2,0,6
pimp,0,0,0,1,0,1
artist,2,0,0,0,2,4
primo,0,0,0,0,1,1
parasitic,1,1,0,1,0,3
borrow,1,0,1,0,1,3
worried,1,1,0,0,1,3
diddy,1,0,0,0,1,2
roger,2,2,2,2,2,10
carolans,1,1,0,0,1,3
bombs,1,0,1,0,1,3
hotness,1,1,1,1,1,5
where,28,13,16,18,24,99
vision,2,0,1,0,1,4
espoirs,1,1,0,0,1,3
isabel,1,0,1,1,1,4
gangster,2,1,2,2,2,9
corre,0,0,2,0,2,4
juazeiro,1,1,0,1,0,3
ojitos,0,1,0,0,1,2
jumped,3,3,0,1,1,8
bootleg,0,1,0,0,0,1
lonley,1,0,0,1,1,3
teeny,1,0,0,1,1,3
clavo,1,1,0,1,1,4
sable,1,1,1,1,1,5
etouffe,0,1,0,0,1,2
jobs,1,0,1,1,0,3
lettin,1,0,0,0,0,1
caah,0,0,0,0,1,1
apparition,1,0,0,0,0,1
screen,2,1,2,2,1,8
concentrate,1,1,1,0,1,4
spare,2,1,1,1,1,6
persiana,1,0,0,0,1,2
spark,1,1,0,1,1,4
openbare,1,1,0,1,1,4
gnrique,1,0,0,1,1,3
mans,3,2,2,1,2,10
kardiogramm,1,0,0,1,1,3
many,5,3,0,0,3,11
jokers,0,1,0,0,0,1
dissidents,1,1,1,1,1,5
mana,0,0,0,1,0,1
manh,2,3,0,1,1,7
expression,0,1,0,0,0,1
mann,2,1,1,2,1,7
recordemos,0,0,0,0,1,1
olingi,0,1,0,0,0,1
stereophonic,0,2,0,2,2,6
anti,0,0,0,1,1,2
electrique,1,0,1,1,1,4
boar,0,1,0,0,0,1
mousetrap,1,1,0,0,1,3
boat,1,0,1,1,1,4
erden,1,0,0,1,0,2
collides,1,0,0,1,1,3
carino,1,1,0,1,1,4
west,5,5,2,3,5,20
vacation,2,0,1,1,2,6
concede,1,0,1,1,1,4
breath,4,0,0,2,3,9
earnshaws,0,0,0,1,0,1
influence,1,1,0,0,0,2
thousand,2,0,0,0,2,4
singalong,1,0,1,0,0,2
chao,0,0,0,0,2,2
vodne,1,1,1,0,1,4
runnin,2,1,1,1,2,7
polly,1,0,1,0,0,2
zearocks,0,0,0,0,1,1
tribal,0,0,0,1,0,1
whatevers,1,0,0,0,1,2
blackhawk,1,1,0,0,1,3
spotlight,1,0,1,0,1,3
binaural,0,3,0,3,3,9
aktensilvestereinlagendein,0,0,0,0,1,1
canon,1,0,1,1,0,3
dubious,1,1,1,1,1,5
twista,0,0,1,0,0,1
nation,2,0,1,1,2,6
desejo,0,1,0,0,0,1
binary,0,0,1,0,0,1
inoculated,1,0,0,0,0,1
fatima,1,1,0,0,1,3
coconuts,1,1,0,1,1,4
breakdown,3,1,2,2,3,11
laula,1,0,0,1,1,3
sickness,1,0,0,0,0,1
bside,1,1,1,1,1,5
halfblood,0,0,0,2,0,2
hummingbird,2,1,1,2,1,7
costa,1,0,0,1,1,3
colorblind,1,0,1,1,0,3
vacant,0,0,0,0,1,1
nothin,4,1,0,2,0,7
genio,1,1,0,1,1,4
dimension,2,0,1,1,2,6
summer,16,6,5,9,11,47
whitfield,1,0,1,1,0,3
being,3,0,3,0,0,6
hades,1,0,1,0,0,2
galopera,1,1,0,0,0,2
inaudible,1,0,0,0,1,2
darien,1,1,0,1,1,4
rover,1,1,0,1,1,4
distancia,0,0,0,0,1,1
bricks,1,0,0,0,0,1
skies,4,0,2,3,4,13
zion,3,2,0,3,2,10
around,24,14,9,17,22,86
shakuhachi,0,1,0,1,0,2
abagui,0,0,1,0,0,1
sodding,1,0,0,1,1,3
dark,10,8,3,7,6,34
traffic,2,0,2,1,1,6
world,46,37,18,38,37,176
dare,0,0,0,1,1,2
stranger,8,3,2,4,2,19
enero,0,0,0,1,1,2
wordless,1,0,0,1,0,2
souvenirs,1,0,2,1,2,6
gimme,3,0,1,1,1,6
enerv,1,1,0,0,1,3
clay,0,1,0,1,0,2
sellotape,0,0,0,1,1,2
inter,0,0,0,0,1,1
clap,1,1,0,1,1,4
junco,1,1,0,1,0,3
pickled,1,1,0,1,0,3
percussio,0,1,0,1,1,3
leng,0,0,0,0,2,2
divine,0,1,0,1,1,3
yesss,0,0,1,1,1,3
revenger,1,0,0,0,1,2
memories,0,0,0,1,0,1
tube,0,0,0,1,0,1
lend,1,0,0,1,1,3
ouro,0,1,0,0,0,1
ritmo,1,0,0,0,1,2
exit,0,0,0,0,1,1
juggernaut,1,0,1,1,0,3
power,4,3,1,5,3,16
sprung,1,0,1,1,1,4
lametavolante,0,0,0,1,1,2
jugglin,0,0,0,1,0,1
travelin,1,1,0,0,1,3
stone,4,1,3,2,3,13
esquilo,1,1,1,0,0,3
volumatic,1,0,1,1,1,4
neighbor,2,0,0,0,0,2
bond,1,1,1,1,0,4
berger,0,0,0,1,0,1
chivalry,1,1,1,1,1,5
burning,4,0,2,1,2,9
reconnu,0,1,0,0,0,1
antidote,1,0,0,0,1,2
hypnotise,1,0,0,1,1,3
charly,1,0,1,1,1,4
cerpin,1,0,1,1,0,3
apologize,0,0,0,1,0,1
mariage,1,1,0,1,1,4
rosso,0,0,0,1,0,1
faheem,0,1,0,1,0,2
braes,1,0,0,0,0,1
tropical,0,1,0,0,0,1
reinvigorated,1,0,0,1,0,2
aguas,1,1,0,1,0,3
cerises,0,1,0,1,1,3
mindless,1,0,0,2,1,4
worshippers,0,0,0,1,0,1
rudeboy,2,1,1,1,1,6
abandonada,0,1,0,0,0,1
bubble,2,1,0,1,2,6
goodman,0,0,0,0,1,1
lang,1,1,1,1,1,5
complete,3,2,1,0,2,8
limelighters,0,1,0,1,1,3
rainin,1,0,0,1,1,3
beginners,0,1,0,0,1,2
mich,6,3,2,5,6,22
with,65,39,17,41,59,221
mica,1,0,0,1,1,3
abused,1,0,1,0,0,2
pull,3,1,0,2,3,9
rush,1,0,1,0,1,3
raga,1,1,0,1,1,4
vanit,1,0,0,0,1,2
monopoly,1,1,1,1,0,4
monopatia,0,0,0,0,1,1
rago,1,1,1,1,1,5
ruse,1,0,1,0,0,2
dirty,8,4,3,5,7,27
jackhammer,1,0,0,1,1,3
darker,1,0,0,0,0,1
munda,1,0,0,1,1,3
gone,14,12,9,9,14,58
johnny,6,3,2,2,6,19
dnde,0,1,0,0,0,1
wartime,0,1,0,0,0,1
keinu,1,0,1,0,1,3
walked,0,0,0,0,1,1
frederali,0,1,1,0,0,2
watched,0,1,0,0,1,2
sawyer,1,0,0,0,1,2
cream,4,2,0,1,2,9
yoga,0,0,0,1,0,1
monsieur,0,1,0,0,1,2
muneca,0,1,0,1,0,2
tight,2,1,1,1,1,6
montanara,1,1,1,1,1,5
terre,1,0,1,1,1,4
annes,1,0,1,1,1,4
terra,0,0,0,1,0,1
averys,0,1,0,0,1,2
velvet,0,0,0,0,1,1
apartamento,0,0,0,0,1,1
mase,1,1,1,0,1,4
meditacao,1,1,0,0,0,2
clowning,1,1,0,0,0,2
hello,9,4,2,3,8,26
scudi,1,0,0,1,1,3
mass,1,0,1,2,3,7
nelson,1,1,0,1,1,4
acido,1,0,1,0,1,3
original,34,25,13,31,30,133
mauna,1,1,0,1,1,4
turbocharger,1,0,1,1,0,3
siyabonga,1,0,0,1,0,2
mason,2,2,0,0,2,6
verstehst,1,1,1,1,1,5
rapaz,0,1,0,1,0,2
hunting,1,1,0,1,1,4
tail,2,1,2,1,2,8
unreleasedrerecorded,1,0,0,0,0,1
tristeza,1,1,1,0,1,4
smile,7,7,4,5,9,32
crehans,1,1,0,0,0,2
feria,1,2,0,1,2,6
dulcimers,0,1,0,1,0,2
swallows,0,0,0,1,0,1
bator,1,1,1,1,1,5
floater,0,0,0,1,0,1
sans,1,2,1,2,1,7
cable,1,0,0,1,1,3
merrygorunaround,1,1,0,0,0,2
laying,0,0,0,1,1,2
dinosaur,2,1,2,2,2,9
sand,4,2,1,6,4,17
harry,2,2,3,4,3,14
small,4,3,2,2,4,15
largo,0,0,1,1,0,2
herzen,0,0,0,0,1,1
pasa,1,0,0,0,1,2
paso,0,0,0,0,1,1
healed,1,1,0,1,1,4
past,1,0,0,1,0,2
cheatin,1,1,0,1,1,4
pass,5,4,1,3,5,18
healer,2,0,0,1,1,4
gitana,1,1,0,1,2,5
poisonous,1,1,0,1,0,3
fleur,0,1,0,1,0,2
inolvidable,0,1,0,0,0,1
pecado,1,0,0,0,1,2
full,7,4,5,4,5,25
hours,3,0,2,2,3,10
tiis,1,1,1,1,1,5
palin,2,0,2,2,0,6
november,1,1,1,1,1,5
legend,1,1,1,0,2,5
pachelbel,1,0,1,0,0,2
melancholia,1,0,1,0,1,3
vlada,0,1,0,0,0,1
brutal,1,1,0,1,1,4
restcure,1,0,1,0,1,3
pick,0,0,0,0,1,1
raza,1,1,0,1,1,4
luck,6,4,3,2,5,20
dubbaq,0,0,0,1,0,1
slammin,1,0,0,0,1,2
silva,1,1,1,1,1,5
medianoche,1,1,0,0,1,3
pears,0,0,1,1,0,2
pokrusa,1,0,0,0,1,2
gorgeous,1,0,1,1,1,4
ballad,3,1,1,1,3,9
more,37,23,14,27,30,131
teen,0,0,0,1,1,2
door,6,2,3,5,7,23
kassoule,1,1,0,0,1,3
company,1,0,1,0,1,3
recordame,0,1,0,1,0,2
hotta,1,1,1,1,1,5
tntriko,0,0,0,0,1,1
doom,1,0,0,0,0,1
gravel,0,1,0,0,0,1
damien,1,0,0,0,1,2
science,1,1,1,1,1,5
malo,1,0,0,0,1,2
morgan,0,0,0,0,1,1
learn,1,2,0,2,0,5
knocked,2,1,1,1,2,7
seagull,1,0,1,1,1,4
zurezko,0,0,0,0,1,1
watcha,1,0,0,1,1,3
mala,0,0,0,1,1,2
beautiful,9,6,5,5,9,34
wieder,2,0,2,2,2,8
siks,1,1,0,0,1,3
ponte,1,1,1,1,1,5
rodriguez,1,1,0,0,1,3
neglected,1,0,1,0,1,3
ponto,0,0,0,1,1,2
accept,2,1,0,0,1,4
allegro,4,2,0,5,6,17
autumn,4,4,2,4,3,17
ponts,1,1,0,0,1,3
auer,1,0,0,1,1,3
sense,1,0,0,1,1,3
laukimas,1,0,0,0,0,1
mehr,2,0,1,1,1,5
scat,1,0,0,1,1,3
disconsolate,0,0,1,0,0,1
lejos,1,1,0,1,1,4
jhala,1,1,0,1,1,4
cline,1,1,0,1,1,4
creature,1,1,0,0,0,2
meraviglioso,1,1,0,1,1,4
armageddons,1,0,0,1,0,2
loefahs,1,0,0,1,1,3
brett,1,1,0,0,1,3
soundtrack,1,0,1,0,1,3
plane,1,0,1,1,1,4
scientas,1,0,1,1,1,4
saimera,0,0,0,1,0,1
leroy,1,0,0,1,1,3
rosebud,1,1,0,1,0,3
deuces,1,1,0,1,1,4
ogdens,1,0,1,0,1,3
putting,1,0,0,0,1,2
townson,1,1,0,1,0,3
mexican,0,1,0,0,1,2
letem,1,0,1,1,1,4
papel,1,0,0,0,1,2
trade,1,0,0,0,1,2
bksi,1,1,0,1,0,3
attitude,1,1,0,0,1,3
paper,7,4,3,2,4,20
scott,0,1,0,1,0,2
brin,1,1,0,0,1,3
signs,1,0,1,3,1,6
bulldozers,1,0,1,0,1,3
broadway,2,1,0,0,0,3
smiling,1,1,0,1,1,4
sahti,1,0,0,0,0,1
fonsi,0,0,0,0,1,1
alla,2,2,2,3,2,11
poetic,1,0,0,0,0,1
alli,0,0,0,0,1,1
superfly,1,0,0,0,0,1
tiempos,1,0,1,0,0,2
digas,1,0,1,0,1,3
tflische,0,0,0,0,1,1
sucker,1,0,0,0,1,2
personne,1,1,1,0,1,4
zhen,0,0,0,0,1,1
snowball,1,1,1,1,1,5
olivia,1,1,0,1,1,4
weeds,0,1,0,1,0,2
galope,0,1,0,0,1,2
dede,0,0,0,0,1,1
everytime,1,0,1,1,1,4
always,3,2,1,3,6,15
warung,0,0,0,2,0,2
found,5,2,3,2,4,16
vilking,1,1,0,1,1,4
upstairs,2,1,0,2,1,6
nossa,0,1,0,0,0,1
mackenzie,0,1,0,1,0,2
tonite,1,0,1,1,2,5
blues,78,79,25,29,41,252
really,3,4,1,4,4,16
suon,1,0,0,0,1,2
garvey,0,0,0,0,1,1
diskola,0,0,0,0,1,1
grottans,1,0,0,1,1,3
mikawa,0,1,1,1,1,4
darling,2,0,1,1,3,7
highway,2,2,0,0,2,6
guayabera,0,1,0,0,1,2
risen,2,0,1,0,0,3
drifting,2,2,0,2,2,8
weeg,1,0,0,0,0,1
porcelain,1,1,0,1,0,3
sparked,1,1,1,1,1,5
garons,1,0,0,1,1,3
entonces,1,0,0,0,1,2
imagino,1,0,0,0,1,2
weez,1,1,0,1,0,3
patitu,1,0,0,1,1,3
sensations,0,0,0,1,0,1
bumper,1,0,0,0,0,1
castle,4,3,1,3,3,14
major,4,1,1,2,3,11
guan,0,0,0,0,1,1
murallas,0,0,0,0,1,1
number,1,0,1,1,0,3
slipper,1,0,0,1,1,3
wees,1,1,0,0,0,2
ethereal,1,0,0,0,1,2
glitter,1,1,0,1,1,4
guess,0,1,0,0,1,2
heads,1,2,0,1,1,5
guest,1,0,1,1,1,4
introduction,3,2,1,1,2,9
avec,1,0,0,1,1,3
felicidades,1,1,0,1,0,3
saint,1,0,0,1,0,2
cunoasterea,1,0,0,1,0,2
unutmam,0,0,0,1,0,1
divertido,0,1,0,0,0,1
relationship,0,1,0,1,0,2
tbone,1,1,0,1,1,4
ernestine,1,1,1,1,1,5
stairs,2,0,1,2,2,7
grace,5,3,0,2,4,14
chahida,0,0,0,1,0,1
rappin,0,2,0,0,0,2
ablaze,1,0,0,0,0,1
desaster,1,1,0,1,0,3
getaway,1,1,0,1,0,3
vocal,5,1,2,3,4,15
freud,0,0,0,0,1,1
blons,0,1,0,0,0,1
cleos,1,1,0,1,1,4
suffocating,1,0,0,0,0,1
bavarian,0,1,0,1,0,2
antarctica,2,0,0,1,2,5
blond,0,1,0,0,1,2
suavecito,0,1,0,0,1,2
carlo,1,0,0,0,1,2
self,1,0,0,1,1,3
frail,1,0,1,1,1,4
play,7,6,2,3,5,23
brooklyn,1,0,0,0,1,2
plan,4,2,1,7,8,22
darts,1,0,1,1,0,3
buried,2,0,0,0,2,4
arson,1,0,0,0,1,2
seize,1,0,0,2,1,4
sometimes,5,1,3,2,3,14
cover,4,0,0,3,2,9
raag,1,1,1,1,1,5
coven,1,0,1,0,0,2
mompfreedonium,0,0,0,0,1,1
wishy,1,1,0,0,0,2
galicia,1,0,0,2,1,4
croix,1,0,0,0,1,2
gold,6,3,3,5,4,21
quiereme,0,1,0,0,1,2
toujours,2,0,2,2,2,8
fiann,0,1,0,0,0,1
session,3,3,1,1,3,11
freight,1,1,0,0,0,2
rebeneb,1,0,0,1,0,2
occupation,1,1,1,1,1,5
vltozott,1,0,1,1,1,4
sayin,0,0,0,1,0,1
writes,1,1,1,1,0,4
writer,1,0,1,1,0,3
failed,1,0,1,1,1,4
gracieusette,0,1,0,0,1,2
cassette,1,1,1,1,1,5
symptom,1,1,0,0,1,3
factor,1,0,0,0,0,1
turnaround,1,0,0,0,0,1
zephyrus,1,0,0,1,1,3
giants,1,1,0,1,0,3
downpour,1,0,1,0,1,3
toby,1,1,0,3,1,6
sunny,2,1,0,2,2,7
vuelves,0,0,0,1,1,2
remedy,0,1,0,0,1,2
banner,1,1,0,0,2,4
progressive,1,0,0,0,1,2
ahmea,1,0,0,1,1,3
roughest,1,0,0,0,0,1
belles,1,0,1,1,1,4
croatia,2,0,0,0,0,2
scelxenak,1,1,0,1,0,3
manger,2,1,0,2,2,7
anglois,1,1,1,0,1,4
noize,1,0,1,1,1,4
aberdeen,1,1,0,0,0,2
outward,0,1,0,1,1,3
knees,3,2,0,2,3,10
movin,1,0,1,1,1,4
ritz,1,0,1,0,1,3
movie,0,0,0,2,1,3
demons,1,0,1,0,0,2
lihava,1,0,0,0,0,1
vitamina,0,1,0,0,0,1
rite,0,1,0,0,0,1
monsters,2,1,2,2,1,8
rita,0,1,0,1,0,2
europe,2,0,2,1,1,6
losangeles,1,1,1,0,0,3
temblando,0,0,0,0,1,1
adagio,4,2,1,1,3,11
prospects,5,0,5,5,0,15
lass,0,1,0,0,0,1
last,27,10,15,15,21,88
thou,1,1,0,1,1,4
raineys,1,1,0,0,0,2
troppo,2,1,0,1,2,6
cuerda,0,0,0,0,1,1
radames,1,0,0,1,0,2
colpa,0,0,0,1,1,2
whole,1,0,0,0,0,1
patty,1,1,1,1,1,5
majesty,3,2,0,2,1,8
bell,1,0,0,1,1,3
etre,1,0,1,1,2,5
seems,1,2,1,1,1,6
hollow,1,0,1,2,1,5
leos,1,1,1,1,1,5
eoarchaean,1,0,0,0,0,1
church,3,2,1,2,2,10
pensamiento,1,0,0,0,1,2
belt,1,0,0,1,1,3
devin,1,1,0,1,0,3
devil,8,7,0,5,4,24
prefiero,0,0,0,0,1,1
blink,1,0,0,0,1,2
geoffrey,1,1,0,0,1,3
meseta,1,0,1,1,1,4
firm,1,0,0,0,1,2
mcnamarad,1,0,0,1,1,3
champion,0,0,0,1,0,1
fire,25,10,4,11,14,64
boweavil,1,1,0,0,0,2
gertens,1,0,1,1,1,4
races,2,0,0,2,2,6
awake,2,0,4,3,0,9
chester,0,1,0,0,1,2
funk,4,2,2,5,3,16
mujeres,1,1,0,0,0,2
straight,2,0,0,1,0,3
error,0,0,0,1,0,1
kissing,1,0,0,1,1,3
robin,1,1,0,0,1,3
swim,0,0,0,1,0,1
pound,1,1,1,1,0,4
hoping,1,1,1,1,1,5
moth,1,1,0,1,0,3
calculator,1,0,0,1,1,3
owen,1,1,0,1,1,4
gangstas,0,0,0,1,1,2
xiao,0,0,0,0,2,2
ducks,1,0,0,1,0,2
macarena,0,0,0,0,2,2
trapze,0,0,0,0,1,1
cliftons,1,1,0,0,0,2
chase,2,0,2,2,2,8
funny,1,2,0,0,2,5
adios,3,1,1,1,5,11
objekt,0,0,0,1,0,1
starlight,1,0,0,0,0,1
acabo,0,1,0,0,0,1
politrix,0,0,0,0,1,1
knigin,1,0,0,1,1,3
read,1,1,0,0,1,3
ryegrass,0,0,0,1,0,1
forgiveness,2,1,1,0,2,6
dooley,1,0,0,0,0,1
inferno,1,0,0,1,0,2
eure,1,0,1,0,1,3
codazos,0,1,0,1,0,2
illoin,1,0,0,1,1,3
giorno,1,0,1,1,1,4
fabrication,1,0,1,1,1,4
assabah,0,0,1,1,1,3
makes,2,0,0,0,1,3
conversar,0,0,0,0,1,1
person,1,0,0,0,1,2
leone,0,1,0,0,0,1
rudolph,1,2,0,2,2,7
salva,0,0,0,1,1,2
tanguero,1,1,0,0,1,3
andorra,1,1,0,1,1,4
eager,1,1,0,1,0,3
sydney,2,1,2,1,2,8
romanza,0,1,0,1,0,2
remast,0,0,0,0,1,1
australia,0,0,0,1,1,2
victims,2,1,2,2,1,8
emergency,4,0,1,0,4,9
wives,2,2,1,2,2,9
heilige,1,0,0,1,1,3
shitty,1,0,0,0,0,1
suffering,1,0,0,1,1,3
quest,2,1,1,1,0,5
hitters,1,1,0,1,0,3
kennedy,1,0,0,0,1,2
ivan,0,1,0,0,0,1
disorder,1,0,0,1,1,3
squanderer,1,1,1,1,1,5
goddamn,1,1,1,0,1,4
augmentent,1,0,0,1,1,3
unloved,1,0,1,0,0,2
bounce,1,3,0,4,1,9
palm,2,2,1,0,0,5
greener,1,1,0,1,1,4
curious,1,1,0,1,1,4
wesson,1,1,1,0,0,3
pale,2,1,0,2,2,7
irresistible,1,0,0,1,1,3
gullveig,1,0,0,0,0,1
intocable,1,0,0,0,1,2
sentimentos,1,1,0,1,1,4
monaxias,0,0,0,0,1,1
temple,1,0,0,1,0,2
hypergasm,1,0,1,1,0,3
requiem,2,1,2,1,2,8
kreuzpolka,1,1,0,1,0,3
nowhere,2,1,2,1,2,8
santa,3,4,0,2,3,12
carol,3,2,2,2,3,12
chola,0,1,0,0,0,1
pietra,1,0,0,1,0,2
chatterbox,0,0,0,0,1,1
veces,1,1,1,0,1,4
anything,3,1,2,3,4,13
liberi,1,0,1,0,1,3
melbourne,0,0,0,1,0,1
ambush,1,0,1,1,0,3
almendra,0,1,0,0,0,1
kassie,1,0,1,0,0,2
terapia,1,0,0,0,1,2
into,15,3,8,10,13,49
inti,0,1,0,0,0,1
beira,0,1,0,0,1,2
contestadora,1,1,1,1,1,5
volcan,1,1,0,1,1,4
katie,1,0,0,1,1,3
soca,0,1,0,0,1,2
spending,0,0,0,1,1,2
degero,1,1,1,1,0,4
stenhouse,1,0,0,0,0,1
submit,1,0,1,1,0,3
suis,1,1,1,1,2,6
suit,1,0,1,1,1,4
blueprint,1,1,1,1,1,5
atlantis,1,2,1,0,2,6
jacks,1,0,1,1,1,4
hawaiian,0,1,0,1,1,3
ailleurs,2,0,0,0,0,2
atlantic,0,0,0,1,1,2
atom,0,0,1,0,0,1
ling,0,0,0,0,1,1
coldest,1,1,0,1,1,4
line,6,3,2,3,4,18
fades,1,1,0,1,2,5
grandmre,1,1,0,0,1,3
erick,1,1,1,1,1,5
erica,2,2,1,1,2,8
redeemer,1,0,1,1,1,4
mandown,1,0,0,1,1,3
marseille,1,1,1,1,1,5
consumed,1,0,0,1,0,2
supervisor,1,1,1,1,0,4
schnes,0,0,0,1,1,2
oddity,1,1,1,1,1,5
unsafe,1,1,0,1,0,3
haunt,1,1,1,0,0,3
chat,1,0,0,1,1,3
aulis,1,0,0,1,1,3
phantom,1,0,0,0,1,2
thugs,1,1,0,1,2,5
tara,1,0,0,1,0,2
occasional,1,1,1,1,1,5
ascoltarti,1,0,0,1,0,2
sails,0,1,0,0,1,2
robots,2,1,0,2,1,6
shenandoah,1,0,0,1,1,3
xing,0,0,0,0,2,2
cnlathe,1,1,0,0,1,3
lane,2,2,0,0,1,5
land,3,0,2,3,4,12
lana,1,0,1,0,1,3
lann,1,0,1,1,1,4
dche,1,1,1,1,1,5
adnans,0,0,0,1,0,1
walker,1,1,0,0,1,3
fresh,0,0,0,1,0,1
having,1,1,1,1,1,5
partial,0,1,0,0,0,1
dawning,1,0,0,1,0,2
scratch,1,1,1,1,1,5
laziness,0,0,0,1,0,1
existing,1,0,1,1,0,3
brightside,1,0,1,0,1,3
chillin,1,1,1,1,1,5
cody,1,0,1,0,0,2
seni,0,0,0,0,1,1
popularesasa,1,1,0,1,0,3
young,10,8,7,4,10,39
send,3,1,2,1,1,8
contours,1,1,0,1,1,4
sens,2,1,0,2,2,7
dancehall,1,1,0,1,0,3
sent,1,1,1,1,1,5
garden,3,3,3,3,3,15
tulsa,2,0,2,2,2,8
kuriye,0,0,0,1,0,1
llama,1,1,1,1,0,4
magic,2,1,0,2,1,6
transmission,2,0,0,1,1,4
gettin,3,2,2,3,3,13
anakonda,1,0,1,1,0,3
race,1,1,0,1,1,4
reich,1,0,0,1,1,3
severed,1,0,0,1,0,2
morpha,0,0,1,0,1,2
cuantas,0,0,0,1,1,2
everythings,2,1,0,1,2,6
tora,0,0,1,0,1,2
video,2,2,1,3,2,10
enclosed,1,0,0,0,1,2
index,1,1,0,0,1,3
apparatus,0,0,1,0,0,1
morse,0,0,0,0,1,1
anton,1,0,0,1,0,2
sweaty,1,0,0,0,0,1
indian,3,1,1,3,3,11
twins,1,1,0,1,0,3
bird,3,2,0,2,4,11
balle,0,0,0,0,2,2
seine,1,1,0,1,0,3
jammaster,1,1,1,1,1,5
guama,0,1,0,0,0,1
laddie,0,1,0,0,0,1
terve,1,1,1,1,1,5
fifteen,1,1,0,0,0,2
loser,1,0,0,0,1,2
great,5,4,2,3,5,19
shuffling,1,0,0,0,0,1
derby,1,0,0,1,1,3
popcorn,1,0,1,1,1,4
abupia,1,1,0,1,1,4
stephanie,1,1,1,1,1,5
dsol,1,0,1,1,1,4
thats,6,3,4,2,4,19
manies,1,1,1,1,1,5
tipico,0,1,0,0,1,2
fractured,1,0,1,1,0,3
kokoro,0,2,0,2,2,6
loca,1,0,0,0,1,2
bust,1,0,0,0,1,2
palabra,0,1,0,1,0,2
menino,0,1,0,0,0,1
standing,5,5,1,2,2,15
confidence,0,1,0,0,0,1
theme,13,5,1,12,14,45
next,8,3,4,3,5,23
roda,0,1,0,0,1,2
doubt,1,0,1,0,0,2
paune,0,0,0,1,1,2
baba,1,0,0,0,1,2
babe,1,0,0,0,0,1
kolomeyke,1,0,0,1,1,3
zalozniy,1,0,0,1,0,2
carrying,1,0,0,1,1,3
losin,1,1,1,1,1,5
baby,53,33,13,20,31,150
bihoue,1,0,1,1,1,4
balls,1,1,0,0,1,3
this,62,28,28,37,52,207
ballz,0,0,0,1,0,1
pour,5,0,3,3,3,14
badan,0,0,0,1,1,2
emerson,0,0,0,2,0,2
thin,3,0,2,1,2,8
ballo,2,0,0,1,1,4
melilla,1,0,0,1,0,2
process,1,2,1,3,3,10
lock,2,2,0,2,1,7
loco,1,2,0,3,3,9
pieces,1,0,0,0,0,1
high,14,8,6,8,11,47
spruce,1,0,0,1,0,2
slip,2,0,1,1,1,5
beni,0,1,0,0,1,2
flamenco,0,1,0,0,0,1
trumpet,1,2,0,1,0,4
martyr,1,0,1,0,1,3
mujer,1,0,1,0,1,3
animal,1,0,1,0,0,2
dificiles,1,0,1,0,0,2
comedy,1,0,0,0,0,1
cristal,1,1,1,2,1,6
tien,1,1,1,0,0,3
javalon,1,1,0,1,0,3
gardner,0,1,0,0,0,1
strumentale,0,0,1,1,0,2
hawa,1,0,0,1,1,3
tarantella,0,1,0,0,0,1
robot,1,0,0,1,1,3
zabel,0,1,0,1,0,2
espaol,1,1,0,1,1,4
realizer,1,0,0,1,1,3
noches,1,1,0,0,0,2
counted,1,0,1,1,1,4
houston,0,0,0,1,1,2
standin,2,2,1,1,1,7
kiinni,1,0,0,0,0,1
brahms,1,0,1,0,0,2
bitty,1,0,0,1,1,3
directo,7,0,4,1,7,19
move,8,4,4,4,5,25
produced,2,0,0,2,0,4
ragoo,1,0,1,0,1,3
motorcycle,1,1,1,1,1,5
volta,0,1,0,0,1,2
warren,0,0,0,1,0,1
perfect,5,1,2,2,3,13
inishmore,0,0,0,0,1,1
mediterrani,1,0,0,0,1,2
punchdrunk,1,1,1,1,1,5
thieves,0,1,0,0,0,1
degrees,1,0,1,1,0,3
milkcow,2,2,1,0,2,7
communication,1,0,0,3,0,4
jody,3,2,0,0,1,6
brockington,1,1,0,1,1,4
recept,0,0,0,1,0,1
morgen,0,1,0,1,0,2
nada,1,4,1,2,3,11
mediocre,1,1,1,0,1,4
federico,0,1,0,0,1,2
rossen,1,0,0,0,1,2
kiss,7,4,2,5,6,24
cocotaso,0,1,0,1,0,2
doce,0,1,0,1,0,2
cursed,2,0,1,0,1,4
scenic,1,0,1,1,0,3
vibrations,1,1,1,1,1,5
goodtime,0,0,0,0,1,1
betty,4,2,2,4,3,15
truth,4,2,3,4,4,17
stewkey,1,0,1,0,1,3
beneath,2,2,3,1,3,11
traces,1,0,0,1,1,3
amoria,0,0,0,1,0,1
chickasay,1,0,0,1,0,2
shower,3,3,1,3,0,10
soixantequatre,0,1,0,1,0,2
doing,2,1,2,1,2,8
society,1,0,1,0,1,3
frequency,1,0,0,1,0,2
static,2,1,1,0,2,6
thirteen,0,0,1,0,1,2
jagged,1,0,0,0,1,2
witness,1,1,1,1,1,5
cesa,1,0,1,1,1,4
carita,1,0,1,1,1,4
cest,9,5,5,8,8,35
contigo,2,1,0,2,3,8
czar,1,1,0,0,0,2
shut,2,0,2,1,2,7
tempo,2,1,1,1,2,7
temps,0,1,0,1,1,3
shuo,0,0,0,0,2,2
shui,0,0,0,0,1,1
mesmerized,0,1,0,1,0,2
could,8,7,4,6,6,31
scars,1,1,1,0,1,4
david,2,1,0,3,3,9
blaue,1,0,1,1,0,3
anita,0,1,0,0,0,1
digitaria,1,1,1,1,0,4
piney,1,1,0,0,1,3
loverman,1,0,1,0,1,3
blown,1,1,1,1,1,5
scene,2,0,0,2,1,5
jesus,11,9,5,7,11,43
dendemnner,1,0,1,1,1,4
damit,1,0,0,1,1,3
baiao,1,1,0,1,0,3
affliction,1,0,1,1,1,4
owner,1,1,1,1,1,5
milagre,1,1,0,1,0,3
disaster,1,0,0,0,0,1
festival,2,1,1,2,2,8
traveller,2,2,1,2,2,9
system,2,0,1,3,1,7
ptit,1,2,0,0,2,5
sloignent,1,0,0,0,1,2
stomach,1,0,1,1,0,3
liang,0,0,0,0,2,2
chagrin,1,0,0,1,1,3
burlesque,1,0,0,0,0,1
karuna,1,1,0,1,1,4
thresh,1,0,0,0,1,2
tuscan,1,1,0,1,1,4
chong,0,0,0,0,1,1
groovitation,0,1,0,1,0,2
steel,2,2,0,0,2,6
marrakesh,0,0,0,1,0,1
bother,1,1,0,1,1,4
roberto,0,0,0,0,2,2
gaye,0,0,0,1,0,1
psalm,1,1,0,3,0,5
devotion,1,0,0,1,0,2
collecting,1,0,1,0,0,2
false,2,0,0,0,0,2
ipanema,1,1,0,0,1,3
kutt,1,1,0,1,1,4
lines,2,0,2,1,1,6
partnership,1,1,0,1,1,4
gently,1,0,1,0,1,3
tonight,14,4,5,7,17,47
gentle,1,1,0,1,2,5
zarkov,0,0,1,1,1,3
vaca,1,1,0,0,0,2
brokendown,1,1,0,0,0,2
heft,1,0,0,1,0,2
solls,1,1,1,1,1,5
dishes,2,1,1,1,2,7
lungenkrebs,1,0,0,0,0,1
maclean,1,0,1,1,1,4
hangover,1,0,1,1,1,4
cuatro,1,1,0,1,1,4
sinatra,0,1,0,0,1,2
latina,0,1,0,1,0,2
babes,1,0,1,1,1,4
lindo,0,1,0,0,2,3
linda,1,1,0,0,0,2
korean,1,0,0,1,0,2
sirius,1,1,0,2,0,4
milla,2,2,2,2,2,10
filosofia,1,1,0,0,1,3
brazil,0,0,0,1,0,1
flipside,1,0,0,1,1,3
nerio,1,1,1,1,1,5
device,1,0,1,1,1,4
loafin,1,1,0,0,1,3
perpetuo,1,1,0,1,1,4
viso,0,1,0,0,0,1
paladar,1,1,0,1,0,3
coutant,1,1,0,1,1,4
locust,2,0,1,0,2,5
face,7,6,3,5,9,30
donneznous,1,0,1,1,1,4
wounded,1,0,0,0,1,2
painting,1,1,0,1,1,4
fact,1,1,1,0,1,4
atmosphere,1,0,0,1,0,2
bring,5,2,3,2,3,15
manchester,1,0,0,1,1,3
noirs,0,1,0,1,0,2
rouge,1,3,0,1,1,6
rough,2,1,1,2,2,8
brink,1,0,0,0,1,2
noir,0,1,0,0,1,2
slamka,0,0,0,0,1,1
maputo,1,1,0,0,1,3
declouet,1,1,0,1,0,3
schwarzarbeit,1,1,1,1,1,5
tape,1,0,0,1,1,3
tudo,1,1,0,1,2,5
volts,0,1,0,0,1,2
mmix,0,0,0,1,0,1
bourbon,1,1,0,0,0,2
mikhails,0,1,0,1,0,2
meant,2,1,1,1,2,7
handle,2,1,0,2,2,7
abba,1,0,0,0,0,1
means,2,0,1,2,2,7
lucky,3,3,1,3,2,12
wiggle,1,1,1,0,0,3
livinin,1,1,0,0,1,3
anandi,1,1,0,1,1,4
smash,0,0,0,1,0,1
notas,0,1,0,0,0,1
keiner,1,0,0,1,1,3
reis,1,0,1,1,1,4
souljahz,1,0,1,1,1,4
locaccmaccam,0,1,0,0,1,2
lala,1,0,0,1,1,3
rjouissance,0,1,0,0,0,1
stuff,2,2,1,0,1,6
ganzes,0,0,0,0,1,1
basking,1,0,0,1,0,2
ohio,2,0,0,1,2,5
superstars,1,0,0,1,1,3
darbys,1,0,0,0,1,2
perdido,1,1,0,1,1,4
heartburn,1,1,0,0,1,3
edition,4,3,1,4,1,13
triomusic,1,0,1,1,0,3
packed,1,1,0,1,1,4
dungeon,1,0,0,1,1,3
wire,2,1,0,0,1,4
paseo,1,0,0,1,1,3
waltzing,0,1,0,0,2,3
sietmtn,1,0,1,1,1,4
mies,2,0,1,1,2,6
pistol,1,0,1,1,0,3
youll,7,6,3,6,7,29
email,0,0,0,1,1,2
keynote,1,1,0,1,0,3
bilal,1,1,0,1,1,4
courtyard,1,1,0,1,1,4
bolivian,1,0,1,1,1,4
ende,1,0,1,1,1,4
nieve,1,1,0,2,2,6
lotion,1,0,1,1,1,4
drum,8,1,3,6,8,26
dumbledore,0,0,0,1,0,1
drug,1,0,0,0,1,2
kofw,0,0,0,1,0,1
marta,0,1,0,0,1,2
sangen,1,0,0,0,0,1
viziers,1,1,0,1,1,4
lustrate,1,0,0,1,0,2
mmoire,1,0,1,1,1,4
whispering,3,2,1,3,3,12
labor,1,0,0,0,0,1
meantime,2,1,2,1,2,8
vuelvas,1,0,0,0,1,2
poured,1,0,0,1,0,2
baignoire,0,1,0,0,1,2
feather,2,0,0,0,2,4
waste,2,1,1,0,1,5
louisiana,1,1,0,0,1,3
trinity,1,0,0,1,0,2
choses,1,0,0,0,0,1
eduardo,1,1,0,0,0,2
salvaje,0,1,0,0,1,2
roasting,1,1,0,1,0,3
spain,1,0,1,0,1,3
laser,1,0,1,0,1,3
dsir,0,1,0,0,1,2
barquito,1,0,0,0,1,2
greco,1,0,0,1,1,3
sirne,0,1,0,0,1,2
bathtub,0,0,0,1,1,2
ombre,1,0,0,1,1,3
aliento,1,0,1,1,1,4
mimila,0,0,0,0,1,1
lust,2,2,0,2,1,7
wameru,1,1,0,1,1,4
tenor,0,1,0,0,0,1
ransom,1,0,1,1,1,4
tattoo,2,0,1,2,2,7
terrorist,0,0,0,1,0,1
juan,2,1,1,2,1,7
romance,3,2,1,2,2,10
matthew,2,2,1,1,2,8
paula,0,0,0,1,0,1
sada,0,0,0,1,0,1
ball,2,2,1,2,2,9
columbia,2,0,2,0,2,6
oriza,1,1,0,1,1,4
soeur,1,0,0,0,0,1
bald,1,1,0,1,0,3
upon,6,4,1,5,5,21
hasnt,1,0,0,0,0,1
dust,1,0,1,0,0,2
hartz,1,0,0,1,1,3
therapie,1,0,0,1,1,3
philippic,1,0,0,1,1,3
dstockage,1,1,1,1,1,5
shotgun,1,0,1,0,0,2
colour,1,0,1,1,0,3
sarapatel,0,1,0,1,0,2
patterns,1,0,0,1,1,3
audio,1,0,1,1,1,4
presbytre,1,1,0,1,1,4
albinoni,1,0,1,0,0,2
flesh,1,0,0,1,1,3
momento,1,2,1,0,1,5
shiloh,1,0,0,1,0,2
paul,4,2,1,2,4,13
unplugged,1,1,0,1,1,4
lesk,1,0,0,1,0,2
begin,0,0,0,0,1,1
danser,1,2,1,1,2,7
parfume,1,1,0,1,1,4
nacional,1,0,0,0,1,2
arrest,1,1,0,1,1,4
crack,1,1,1,1,1,5
villagers,1,1,1,1,1,5
parfums,0,1,0,1,0,2
cavasamba,0,1,0,1,1,3
complicity,1,0,1,1,1,4
cruz,1,1,0,1,1,4
cedar,0,1,0,1,0,2
dures,0,1,0,1,0,2
tomara,1,1,0,1,1,4
pienses,1,1,0,1,0,3
poikamies,1,0,0,0,0,1
nordmark,1,0,0,1,0,2
cosas,3,3,0,2,2,10
stagger,1,0,1,0,1,3
replacement,1,0,1,1,1,4
bleedin,1,0,1,0,0,2
immortal,1,0,0,0,1,2
daylight,1,0,1,1,1,4
springs,2,2,1,0,0,5
blonde,1,0,0,0,1,2
radioland,1,0,1,0,1,3
unsaveable,1,0,0,0,1,2
breakout,2,0,0,2,1,5
passion,4,4,2,5,4,19
forgiven,1,0,0,0,0,1
stairway,1,0,0,0,1,2
blowing,1,1,0,0,0,2
pressure,1,0,1,0,0,2
ingrato,1,0,0,0,1,2
imaginary,1,1,0,0,1,3
stage,1,1,0,0,1,3
iris,1,1,0,1,0,3
sister,3,1,2,1,2,9
lifestyle,1,0,1,0,1,3
angeles,1,1,1,1,1,5
hier,1,1,0,0,1,3
rockwilder,0,0,0,0,1,1
bescheid,0,0,0,1,0,1
burma,1,1,0,1,1,4
letters,2,1,1,1,2,7
pussy,0,0,0,1,0,1
irreversveis,1,0,0,0,0,1
pianolude,1,1,1,1,1,5
meri,1,0,1,0,1,3
luna,2,3,0,3,2,10
donde,1,1,0,0,1,3
lung,0,0,0,1,2,3
lune,1,1,1,2,2,7
roads,2,1,0,0,0,3
phylyps,1,1,1,1,0,4
mykel,1,0,1,0,1,3
muerto,0,1,0,1,0,2
moonmans,0,1,0,1,1,3
muerte,1,0,1,1,1,4
flynn,0,0,0,0,1,1
function,1,0,1,1,1,4
mathilda,1,0,0,1,1,3
fceelo,1,1,1,1,0,4
marquis,1,1,0,1,1,4
places,1,1,1,1,1,5
underland,0,0,0,1,0,1
smooth,1,1,0,0,1,3
chroniques,0,0,0,1,0,1
chela,0,1,0,0,0,1
mdium,1,0,1,1,1,4
problem,4,1,1,1,1,8
stepmothers,1,1,1,1,1,5
dornrschen,0,0,0,1,1,2
eskomolto,1,0,0,1,1,3
rubble,1,0,1,0,1,3
suan,1,1,0,1,1,4
calle,1,1,0,1,1,4
tsarvitch,0,1,0,0,0,1
seul,1,0,0,1,1,3
details,1,1,0,1,1,4
rosalita,1,1,0,0,1,3
maudits,1,1,1,0,1,4
illusion,1,1,0,1,0,3
reckless,1,1,0,1,0,3
repeat,1,0,1,0,0,2
monday,2,4,0,2,3,11
greasers,1,0,0,1,0,2
footprints,0,0,0,2,0,2
chance,4,3,3,4,5,19
quarto,1,0,0,1,0,2
epilogue,1,0,0,1,0,2
toribio,1,1,0,1,1,4
skincree,1,0,1,1,0,3
ghost,4,2,3,1,4,14
searcher,1,0,0,0,0,1
mozart,3,2,1,1,3,10
rule,1,0,1,0,0,2
strings,0,1,0,0,0,1
eddies,1,1,0,0,0,2
elaine,1,1,1,1,1,5
kickstart,1,1,0,0,0,2
suicidal,1,0,1,0,1,3
rebelion,1,0,0,0,1,2
gesehen,1,0,1,1,1,4
poaki,0,0,0,1,0,1
mansion,0,0,0,0,1,1
saved,2,2,1,2,2,9
drinkin,1,0,1,1,1,4
murmioon,0,0,0,1,1,2
orpheus,0,1,0,0,1,2
qubcois,1,0,0,1,1,3
sahnu,0,0,0,1,0,1
worth,0,0,0,0,1,1
gobbler,1,1,0,1,1,4
aurora,1,1,1,1,1,5
exception,1,0,1,0,0,2
washboard,1,1,0,0,0,2
trinkhalleluja,0,0,0,0,1,1
shitzzo,1,0,0,1,0,2
tickets,1,0,0,0,1,2
bewildered,1,0,0,0,1,2
alovi,0,1,0,0,0,1
monologue,0,0,0,1,0,1
gzlerinde,0,1,0,1,0,2
triumph,0,1,0,1,0,2
jamaica,2,1,0,0,1,4
guitares,2,2,0,1,2,7
horn,2,2,1,2,1,8
preacher,0,1,0,1,0,2
deportees,1,0,1,1,1,4
chen,0,0,0,0,1,1
koobatronmix,1,1,1,1,1,5
panda,1,0,0,1,1,3
poika,1,0,1,1,0,3
freezin,1,0,0,0,1,2
above,5,3,1,2,3,14
lizzie,1,0,0,0,1,2
told,1,1,0,0,0,2
aeroplane,1,1,0,0,1,3
guiter,0,1,0,0,1,2
pursuit,1,1,0,1,1,4
celebration,3,0,2,3,3,11
gossippo,1,1,0,1,1,4
tant,0,0,0,1,0,1
daughter,4,2,1,2,1,10
walkin,3,4,2,2,4,15
bhul,0,0,0,1,0,1
smoke,8,8,1,4,1,22
lonesome,4,4,1,1,5,15
spooks,1,1,1,1,1,5
kindhearted,1,1,0,0,0,2
instr,1,0,1,0,1,3
fiends,0,0,0,0,1,1
darlings,1,0,0,1,1,3
lhorizon,1,1,0,1,1,4
hindsight,0,0,1,0,0,1
total,3,1,2,1,3,10
haendel,0,0,0,0,1,1
sarah,3,0,3,2,1,9
plot,1,0,1,0,1,3
plamuk,0,0,0,0,1,1
alligator,2,2,1,1,1,7
neckbones,1,1,0,0,1,3
cutdown,1,0,1,0,0,2
indiana,1,0,0,0,1,2
blueberry,1,0,0,0,1,2
giovanni,1,1,1,1,1,5
reign,4,2,4,3,4,17
aware,1,0,0,0,0,1
escapist,1,0,0,0,1,2
cured,1,0,0,0,0,1
word,7,1,2,2,6,18
spielin,1,1,1,0,0,3
worm,1,0,1,1,1,4
breakfast,1,0,0,0,0,1
mortar,1,0,0,0,0,1
elbow,0,1,0,1,0,2
shrivasta,1,1,0,1,0,3
gloria,2,1,1,2,2,8
radiance,1,1,1,1,0,4
jest,1,0,0,1,0,2
india,1,1,0,0,0,2
heartless,1,0,0,0,0,1
violin,2,2,0,0,0,4
indifferent,1,0,0,0,1,2
sinnloz,1,0,1,1,0,3
nuts,1,0,0,1,0,2
playgirls,1,0,0,0,0,1
very,2,0,0,1,1,4
rewind,2,1,2,2,2,9
interview,2,1,1,0,1,5
nombre,0,0,0,0,1,1
ordinary,2,0,1,1,1,5
beach,1,0,1,3,1,6
gamble,1,0,0,1,1,3
pizza,1,1,1,1,1,5
fever,1,1,0,0,1,3
merritt,1,0,0,1,1,3
ladder,2,2,1,2,2,9
after,12,8,6,8,11,45
drones,1,0,0,0,1,2
bottles,1,1,0,1,1,4
rebao,0,1,0,1,1,3
arco,2,2,0,1,1,6
poursuivi,0,1,0,0,0,1
cosmonaut,1,0,0,0,1,2
hasta,1,1,0,1,2,5
greek,0,0,1,1,0,2
green,6,4,1,3,5,19
cannonball,2,1,0,0,1,4
ambulance,1,1,0,0,0,2
pdog,1,1,0,1,0,3
order,3,1,2,2,3,11
greed,2,0,2,2,1,7
office,0,0,0,1,0,1
rire,0,0,0,1,1,2
satisfied,1,1,0,1,1,4
ompa,1,1,1,1,1,5
bubbles,0,0,0,0,1,1
venti,1,0,0,1,1,3
somewhere,2,4,3,3,3,15
highlights,1,0,0,1,0,2
venta,0,1,0,0,0,1
vente,0,0,0,1,0,1
introwhatcha,1,1,1,1,1,5
fauch,1,0,0,0,0,1
harmony,4,3,2,3,4,16
versus,2,0,0,0,0,2
then,3,2,2,4,5,16
them,3,0,2,1,1,7
hons,1,1,0,0,1,3
bruttosozialprodukt,1,1,1,1,1,5
thee,2,0,0,0,3,5
safe,6,3,3,4,5,21
deinem,0,0,0,0,1,1
collide,1,1,1,0,1,4
break,12,6,7,11,13,49
band,3,2,3,4,5,17
bang,5,2,2,4,4,17
sentimental,2,2,0,1,2,7
shameful,1,0,0,0,1,2
they,10,4,6,5,8,33
czwarty,1,0,0,1,1,3
bread,2,1,0,0,1,4
gallows,1,0,0,0,1,2
pobre,1,0,0,0,1,2
rocks,3,1,1,1,3,9
volvere,0,0,0,0,1,1
carlow,1,1,0,0,0,2
carlos,1,1,0,1,1,4
lifted,1,0,0,1,1,3
crimes,1,0,1,0,0,2
sled,1,0,1,0,1,3
termiche,1,1,0,1,1,4
trybal,0,0,0,1,0,1
vesela,1,1,1,0,1,4
blows,2,1,1,1,2,7
viertel,1,0,0,1,1,3
strangers,1,0,0,0,1,2
daniel,2,1,1,0,2,6
remorse,1,1,0,1,0,3
medicine,1,0,1,0,0,2
vete,1,0,0,1,1,3
tian,1,0,0,0,5,6
techno,0,0,0,0,1,1
certified,0,0,0,1,0,1
regresa,1,0,0,0,1,2
footsteps,1,1,0,1,1,4
isola,1,1,0,1,1,4
chopped,0,0,0,0,3,3
another,14,5,8,11,13,51
comin,6,2,2,3,3,16
tangle,1,0,0,0,1,2
ballin,1,1,1,1,1,5
mojo,1,2,0,1,0,4
dogg,0,0,0,0,1,1
elevator,1,1,0,2,1,5
compromise,2,1,2,2,0,7
solamente,0,1,0,0,0,1
john,3,4,2,5,4,18
dogs,2,0,0,1,2,5
efface,1,0,0,0,1,2
yourn,0,0,0,0,1,1
innizar,1,0,1,0,0,2
teardrops,2,1,0,2,2,7
albert,2,2,0,2,2,8
booklovers,1,1,0,1,0,3
chanter,1,1,0,1,1,4
wasted,3,0,1,1,2,7
mercy,4,1,2,5,2,14
idnnitkhtr,1,0,1,0,0,2
medley,11,6,2,6,10,35
cristobal,1,1,0,0,2,4
binds,1,0,0,0,0,1
iron,1,2,1,2,1,7
contento,1,0,1,0,1,3
contente,0,1,0,1,1,3
astaire,1,0,0,0,1,2
enchanted,1,2,0,2,1,6
lull,1,1,0,0,0,2
homophobicthe,1,0,0,0,0,1
souplesse,0,1,0,1,1,3
strength,1,0,0,1,0,2
genuine,0,2,1,0,0,3
zapando,1,0,1,1,1,4
gief,1,0,1,1,1,4
rome,1,0,0,0,1,2
circles,3,1,2,1,2,9
maiden,0,1,0,1,0,2
passeur,0,0,0,0,1,1
raindrops,1,1,0,1,1,4
phase,2,0,1,2,2,7
grave,0,1,0,0,1,2
izgoem,1,0,0,1,0,2
ouverture,1,1,0,1,2,5
boyfriends,0,1,0,1,0,2
notion,1,0,1,0,0,2
valleyuhh,0,0,0,0,1,1
idjut,1,0,1,1,1,4
brief,1,0,0,0,0,1
rowena,1,0,0,0,0,1
werther,0,1,0,0,0,1
subtle,1,1,1,1,1,5
damen,1,0,0,0,0,1
consciousness,1,1,1,1,1,5
gaffos,1,1,1,1,1,5
deepest,2,1,0,1,2,6
bailando,1,0,1,0,0,2
robaste,0,0,0,0,1,1
haunted,2,0,1,1,2,6
nasty,1,0,1,0,0,2
runs,1,1,2,1,2,7
poppersmonstermix,1,1,0,1,1,4
selchie,1,1,1,1,0,4
damnation,1,0,1,1,1,4
cattle,1,1,0,1,1,4
outerspace,1,1,0,0,0,2
linsidieuse,1,1,1,1,1,5
pastel,0,1,0,0,0,1
away,33,13,19,19,31,115
olvidarme,0,1,0,0,1,2
bien,4,3,0,2,4,13
tainted,1,0,0,1,1,3
itchycoo,1,0,1,0,1,3
infidel,1,0,0,1,0,2
throwdown,1,1,1,1,1,5
veil,1,0,1,1,0,3
asanin,0,1,0,0,0,1
clues,1,1,0,0,1,3
kaboo,1,0,1,1,1,4
kitchen,0,1,0,0,1,2
zoroastrian,1,1,0,0,1,3
climate,1,0,0,0,1,2
complainin,1,1,0,0,1,3
ragtime,1,1,1,0,2,5
jeffreys,1,1,0,1,1,4
carlstedt,1,1,1,1,0,4
evalia,1,0,1,1,1,4
undone,2,0,1,1,2,6
tough,3,1,2,2,1,9
demain,2,0,1,1,0,4
sobchak,1,0,1,1,1,4
fido,1,0,0,0,1,2
jaye,1,1,1,1,1,5
jtknretale,1,1,1,1,1,5
vekha,0,0,0,1,0,1
tony,1,1,0,1,1,4
paradis,1,0,1,0,0,2
speak,2,3,2,3,2,12
shoulda,0,0,0,1,0,1
charisma,0,0,0,1,0,1
gendarmettes,1,0,0,1,1,3
noel,1,1,0,1,1,4
duties,1,0,0,1,0,2
muir,1,1,0,0,0,2
families,1,0,1,1,0,3
beloved,1,1,0,0,1,3
sauer,1,1,1,1,1,5
comfortable,1,0,0,0,1,2
scripka,1,1,1,1,1,5
matsingena,0,0,0,1,0,1
sampson,1,1,0,0,0,2
ehthros,0,0,0,0,1,1
voici,1,1,1,1,1,5
voice,0,2,0,1,0,3
nonfiction,1,0,0,0,1,2
blakes,0,1,0,0,0,1
cont,1,0,0,0,1,2
razamataz,0,0,0,1,0,1
mision,1,0,0,1,1,3
cone,1,1,0,0,1,3
crawlspace,1,1,1,1,1,5
comerte,1,0,0,1,1,3
miya,0,1,1,1,1,4
wheel,2,3,0,4,2,11
independent,1,0,1,1,1,4
hani,1,0,1,1,0,3
raid,1,0,0,1,0,2
saddam,0,1,0,1,1,3
hang,2,0,0,0,1,3
evil,8,3,3,3,4,21
hand,12,7,0,3,9,31
documents,1,0,0,1,1,3
vermont,1,1,0,1,1,4
kept,2,1,0,1,1,5
hopping,1,1,0,1,0,3
orgasme,1,0,0,1,0,2
contact,2,0,1,2,2,7
mamma,1,2,0,0,2,5
musical,2,1,1,1,2,7
indigo,1,1,0,1,1,4
candilejas,1,0,0,0,1,2
photo,0,1,0,1,1,3
fauvrelle,0,0,0,1,0,1
lixuneanos,1,1,1,1,1,5
thanks,0,0,0,0,1,1
victim,1,1,1,0,1,4
antes,0,1,0,0,1,2
lineman,1,1,0,1,1,4
joso,1,1,0,0,1,3
shout,3,3,1,3,3,13
spread,0,1,0,0,1,2
yoyo,1,1,0,0,0,2
righteous,1,0,1,1,0,3
plasma,1,0,1,1,0,3
desire,3,2,1,2,3,11
insensitive,0,1,0,1,1,3
boxed,1,0,0,0,0,1
olimpos,1,1,0,1,0,3
mayo,0,0,0,1,1,2
chumpman,1,0,0,0,0,1
tranes,0,1,0,1,0,2
aubade,1,1,0,0,1,3
rhymney,1,1,1,1,1,5
mille,1,2,0,1,2,6
skanky,1,0,0,0,1,2
cooler,1,0,1,0,0,2
grizzly,1,0,0,0,1,2
theyre,1,0,0,0,1,2
night,46,25,27,32,36,166
webb,1,1,1,1,1,5
korea,2,1,1,1,1,6
jimmies,1,0,0,0,0,1
laakista,1,1,1,1,1,5
born,10,7,1,6,8,32
stardust,0,1,0,1,1,3
salir,1,0,1,0,1,3
indianola,1,0,1,1,0,3
istime,1,1,0,1,0,3
orchid,1,0,1,0,1,3
purple,1,0,1,1,1,4
entropik,0,0,0,1,0,1
messaggero,0,0,0,0,1,1
indoctrination,1,0,0,0,0,1
slavinka,1,0,0,0,0,1
columbus,1,1,0,0,0,2
dolce,1,1,0,1,1,4
sadie,1,0,0,1,0,2
quedo,0,0,0,1,1,2
shogun,1,0,0,0,1,2
charing,1,0,1,0,0,2
queds,1,0,1,1,1,4
post,1,1,0,0,1,3
meseca,0,0,0,0,1,1
coral,1,0,0,0,0,1
months,1,0,0,0,1,2
horizon,1,0,0,1,0,2
azzurro,1,0,1,0,1,3
jacques,3,1,2,1,3,10
carpal,1,0,1,0,1,3
bound,2,3,1,1,1,8
cante,0,0,0,0,1,1
stumble,1,1,1,1,1,5
overtureblue,1,1,0,1,1,4
deception,0,0,0,1,0,1
manzenera,1,1,1,1,1,5
fight,0,0,0,2,1,3
lovesick,1,1,0,1,1,4
basanti,0,0,0,1,1,2
becoming,0,1,0,0,0,1
snows,1,1,0,0,0,2
tinta,0,0,0,0,1,1
reves,1,1,1,2,1,6
solidao,0,1,0,0,0,1
true,12,7,5,5,7,36
cupareree,1,0,0,1,0,2
veiled,1,0,1,1,1,4
shooby,1,0,1,1,1,4
scrimmage,0,1,0,0,1,2
didgeralia,1,1,0,1,0,3
crystal,1,0,1,0,0,2
emit,1,1,1,0,1,4
promises,1,0,1,0,0,2
rerecording,1,0,0,1,1,3
moore,0,0,1,0,0,1
scandalous,1,1,1,0,0,3
stronger,1,1,0,0,1,3
abstract,1,1,1,1,1,5
skvoz,1,0,0,1,0,2
promised,1,0,1,1,1,4
prayer,6,4,4,5,5,24
tumba,1,2,0,1,0,4
dying,7,4,4,4,6,25
victorys,0,0,0,1,0,1
reality,0,0,0,1,0,1
suburban,1,0,0,0,0,1
shrine,1,0,0,0,0,1
test,2,0,2,3,2,9
fairground,1,1,0,0,1,3
welcome,5,3,1,6,8,23
santeleco,0,1,0,0,0,1
belive,0,0,0,1,0,1
tajima,1,1,0,1,1,4
superscout,1,0,1,1,1,4
together,12,9,8,8,11,48
beds,1,1,1,1,1,5
nigun,0,1,0,1,0,2
songs,1,0,0,0,1,2
danco,0,1,0,0,1,2
dance,35,17,15,17,29,113
grateful,1,0,1,0,1,3
battle,6,4,1,5,3,19
birak,0,0,0,0,1,1
zong,0,0,0,0,1,1
zone,4,2,3,2,3,14
donner,1,1,1,1,1,5
flash,1,1,0,1,2,5
motivopop,1,1,0,0,1,3
permanently,1,0,0,0,1,2
rhythm,1,4,0,2,2,9
terror,1,0,1,0,0,2
brown,10,6,5,3,6,30
ihnen,0,0,0,1,0,1
anonymous,1,1,1,1,1,5
kitten,1,1,0,0,1,3
trouble,4,2,1,3,3,13
bamboozle,1,0,0,0,1,2
guitars,1,0,0,0,0,1
pontchartrain,1,1,0,0,0,2
revolution,5,2,2,3,3,15
bedroom,2,1,1,2,1,7
cost,1,1,1,0,0,3
curse,4,1,1,3,2,11
jeric,0,0,0,0,1,1
sleepwalker,1,0,0,0,1,2
scaffold,1,1,0,1,1,4
rockstarslive,1,0,0,1,0,2
uniform,1,1,1,1,1,5
quedar,1,0,1,1,1,4
serban,1,0,0,0,1,2
kusetus,1,0,0,0,0,1
popovic,1,0,0,0,1,2
spinna,1,0,0,0,1,2
sleepwalkers,1,1,0,1,0,3
coochie,1,1,1,1,1,5
change,16,7,5,11,12,51
sending,1,1,1,0,0,3
flames,1,0,1,1,0,3
nievitch,1,1,0,0,1,3
screamin,1,0,0,0,0,1
trial,1,1,0,0,1,3
locomotion,1,1,0,1,1,4
pillow,3,3,1,1,3,11
homecoming,2,0,1,0,2,5
burp,1,0,0,1,1,3
cien,0,0,0,0,1,1
paragon,0,1,0,0,0,1
italiano,1,1,0,1,1,4
uphill,1,0,0,0,0,1
sincerely,1,0,0,1,1,3
stings,2,0,1,1,1,5
should,4,2,2,3,4,15
market,2,0,0,1,0,3
prove,2,1,1,0,2,6
pusher,1,1,1,1,1,5
selecta,1,0,0,1,1,3
live,178,80,97,106,154,615
soki,0,1,0,0,0,1
angels,6,1,3,4,3,17
matador,1,3,0,2,2,8
ukkosenjumalan,1,0,1,1,0,3
entrance,1,1,0,1,1,4
bellini,0,0,0,1,0,1
club,15,4,9,18,16,62
abramz,1,0,0,1,0,2
foxboro,1,0,1,0,1,3
verliebst,1,0,0,1,1,3
niggaz,0,0,0,0,1,1
hope,5,2,4,2,6,19
diddley,1,0,0,0,0,1
jveux,1,0,1,1,1,4
burrinha,0,1,0,0,1,2
heart,44,24,12,29,41,150
dedicated,2,3,1,2,3,11
serus,1,0,1,0,0,2
nema,0,0,0,0,1,1
vnner,0,0,0,1,0,1
noch,1,0,1,1,1,4
topic,1,0,1,1,1,4
heard,5,5,2,3,6,21
chin,0,0,0,0,1,1
chim,0,2,0,2,2,6
airplane,1,0,0,0,0,1
lluvia,1,0,1,0,1,3
lounge,1,0,1,1,1,4
nonstop,0,0,0,1,0,1
zimmerman,1,0,1,0,0,2
sacrifice,1,0,1,1,0,3
southern,1,1,1,2,2,7
stripes,1,0,0,0,1,2
drastic,1,1,0,0,1,3
heroes,1,1,0,0,1,3
acorden,1,0,0,0,1,2
meteores,0,0,0,1,0,1
remember,7,5,4,6,8,30
cubanas,0,1,0,0,0,1
explicit,23,10,3,10,28,74
hifi,1,1,1,1,1,5
nosed,0,1,0,1,1,3
vaya,1,1,0,1,1,4
tagged,1,0,1,0,0,2
tncdallamok,1,1,0,1,0,3
coln,1,0,0,1,1,3
brain,2,1,2,0,1,6
orgullo,0,1,0,0,0,1
cold,10,5,3,6,6,30
still,18,11,12,14,19,74
birds,1,1,0,0,1,3
earplugs,1,0,0,1,1,3
revivalism,1,0,1,1,0,3
willow,1,1,0,1,1,4
dejarte,1,0,1,1,1,4
ducktails,1,0,1,1,0,3
wixa,0,0,0,1,0,1
norway,1,0,1,1,1,4
evol,1,0,0,1,0,2
clasico,0,0,0,0,1,1
guajira,2,2,0,1,1,6
maquina,0,1,0,2,0,3
extrication,1,1,1,1,0,4
hala,1,1,0,1,0,3
adrenaline,1,0,1,1,1,4
halleluja,1,0,1,0,1,3
half,6,1,3,2,4,16
recap,0,0,0,1,0,1
perdu,1,1,0,1,1,4
hall,4,3,1,4,4,16
galloping,1,1,1,1,1,5
wont,6,5,3,6,7,27
concerto,5,3,0,3,5,16
fumes,1,0,1,0,0,2
boheme,0,0,0,0,1,1
james,5,6,1,3,4,19
drop,3,0,1,2,3,9
magan,0,0,0,0,1,1
aquacityboy,1,1,0,1,1,4
desde,1,0,1,2,1,5
stockholm,1,1,1,1,1,5
bhabhiyie,0,0,0,1,0,1
kann,1,1,0,1,1,4
kano,0,1,0,1,0,2
danchall,0,0,0,0,1,1
mangos,0,1,0,0,0,1
hymne,0,1,0,0,1,2
goose,1,0,0,0,1,2
mulher,0,1,0,0,1,2
year,7,1,4,1,7,20
happen,2,2,1,1,1,7
pills,1,0,0,1,1,3
tried,0,0,0,0,1,1
album,362,120,171,146,304,1103
space,8,3,4,4,6,25
llamada,0,0,0,0,1,1
thirst,0,0,0,0,1,1
looking,8,5,3,4,5,25
messiaen,0,0,0,1,0,1
cars,1,0,1,0,1,3
scrooges,1,0,0,0,1,2
medalla,0,0,0,1,1,2
unwanted,1,0,0,0,1,2
caro,0,1,0,0,0,1
marina,1,0,1,1,1,4
cara,0,1,0,1,1,3
marine,0,1,0,0,1,2
trange,1,0,1,1,1,4
card,1,1,0,0,0,2
care,6,2,3,3,2,16
lhemms,1,0,1,1,1,4
goodnights,1,0,0,0,0,1
deprivation,1,0,1,1,1,4
pegadito,1,0,0,0,1,2
blind,2,0,1,0,0,3
ouyounik,0,0,1,1,1,3
jumke,0,0,0,1,0,1
yourself,5,4,3,4,6,22
proibida,1,1,1,1,1,5
ring,4,3,1,0,4,12
tomorrow,11,5,5,8,8,37
size,2,1,1,0,1,5
silent,6,6,1,4,8,25
caught,5,1,2,3,4,15
gardien,1,0,0,0,0,1
rakkahin,1,1,0,0,1,3
vampyyri,1,0,1,1,1,4
friend,11,7,7,5,8,38
mostly,0,1,0,0,0,1
that,46,31,16,25,41,159
brains,1,0,0,0,0,1
crackbabies,1,1,1,0,1,4
qual,1,0,0,1,1,3
quan,0,0,0,0,1,1
hillbillies,1,1,0,0,0,2
flowers,4,3,1,2,6,16
than,18,8,8,10,17,61
rugged,0,0,0,0,1,1
gemstones,1,1,0,0,1,3
vocals,5,1,0,1,4,11
apples,2,2,1,1,2,8
fruits,1,0,0,1,0,2
fruity,0,1,1,0,0,2
angel,18,14,6,13,16,67
vitaminas,1,0,0,0,1,2
boomshackalack,0,0,0,1,0,1
premier,1,1,0,1,1,4
gitanos,2,0,0,2,2,6
slap,1,0,0,1,0,2
loko,1,1,0,1,1,4
anges,1,1,0,1,1,4
insatiable,1,0,0,1,0,2
slab,1,1,0,1,1,4
windsor,0,0,0,1,0,1
jardin,0,1,0,0,1,2
deux,4,3,0,1,4,12
jardins,1,0,1,1,1,4
deus,1,1,1,1,1,5
santiago,2,0,1,1,2,6
prick,1,0,0,0,0,1
price,2,2,1,0,1,6
chorando,0,1,0,0,0,1
america,2,1,2,1,1,7
fersen,1,1,0,1,1,4
destiny,1,0,0,1,1,3
michelle,2,1,2,1,2,8
forever,16,7,12,16,13,64
atfcs,1,0,0,1,1,3
alguna,1,0,0,0,1,2
steady,5,3,2,2,3,15
alfil,1,1,1,1,0,4
verbals,1,1,0,1,0,3
slaves,1,0,1,0,1,3
sexing,1,0,1,1,1,4
rambling,1,2,0,0,1,4
malheureux,1,1,0,1,1,4
ground,3,2,2,2,1,10
aint,29,23,8,15,20,95
title,2,2,1,3,3,11
saints,1,1,0,2,0,4
september,3,2,2,3,3,13
only,26,18,10,19,26,99
sierra,0,1,0,0,0,1
ainm,1,0,0,0,0,1
jole,0,1,0,0,0,1
pumpkin,0,0,0,1,1,2
fledermaus,0,0,0,0,1,1
cannot,1,0,1,1,1,4
cryin,1,1,1,0,2,5
deborahs,1,0,0,0,1,2
leather,1,0,0,1,1,3
imbecile,1,0,1,1,1,4
breeches,1,1,0,0,1,3
losers,1,1,0,1,1,4
criscoteque,1,0,1,1,1,4
musette,2,2,0,0,2,6
amoureux,1,0,0,0,0,1
concert,4,0,4,3,3,14
godere,1,0,0,0,1,2
ends,3,1,3,0,3,10
hoes,0,0,0,1,0,1
maana,1,0,1,0,0,2
troubadour,1,1,1,0,0,3
dompfaff,1,1,0,1,1,4
estar,1,0,0,0,1,2
estas,3,0,1,0,2,6
between,9,1,5,4,7,26
notice,2,1,1,0,2,6
unlocks,1,0,0,0,1,2
widersacher,1,1,0,0,1,3
blame,5,1,1,3,1,11
hurts,2,0,1,0,2,5
comeback,1,1,1,1,1,5
goodsall,1,1,1,1,1,5
impromptu,1,1,0,0,0,2
duet,1,0,1,1,2,5
mona,1,0,0,0,0,1
mono,2,1,0,2,2,7
monk,1,1,0,1,0,3
timour,0,1,0,1,0,2
moni,0,0,0,0,1,1
wheels,1,1,0,1,0,3
prequel,1,1,0,0,0,2
comes,5,5,1,6,10,27
kilometros,0,0,0,0,1,1
madness,2,2,0,2,2,8
plaisancefox,0,1,0,0,1,2
cuando,1,0,1,2,3,7
basilica,1,0,0,0,1,2
taryns,1,1,0,1,1,4
learning,2,1,1,1,2,7
punisher,1,0,0,1,1,3
cycling,0,0,0,1,0,1
sest,1,1,0,0,1,3
cares,4,1,1,2,3,11
cared,0,1,0,1,1,3
informer,1,0,0,1,1,3
scumfrog,1,1,1,1,1,5
foggy,1,1,0,1,1,4
ruby,3,1,1,2,1,8
these,8,2,1,5,6,22
mouton,0,1,0,0,1,2
trick,0,0,0,1,0,1
crump,1,0,0,1,1,3
bogart,0,0,0,1,0,1
bian,1,0,0,0,1,2
sudanese,0,0,1,1,0,2
embrace,0,0,0,0,1,1
heels,2,1,2,1,2,8
return,2,1,1,1,2,7
helium,1,0,0,1,0,2
floating,2,2,2,2,1,9
worry,3,1,0,0,3,7
pastas,1,0,0,0,1,2
esteban,2,0,2,0,2,6
gentlemen,1,2,0,1,1,5
motherless,0,1,0,0,0,1
epoch,1,0,1,1,1,4
finish,1,0,0,0,0,1
arctic,1,0,1,1,0,3
foam,1,1,0,0,0,2
daquitaine,1,0,0,0,1,2
fruit,1,1,1,1,1,5
voulait,1,1,0,1,1,4
wessex,1,1,0,1,1,4
severe,1,0,0,1,1,3
breeze,0,0,0,0,1,1
holli,0,0,0,1,0,1
taxi,1,1,0,1,1,4
frankie,3,1,1,2,2,9
noah,1,0,0,1,1,3
neon,2,0,1,1,2,6
narechenny,1,0,0,1,0,2
civilized,1,1,0,1,1,4
anyday,0,0,0,0,1,1
touch,7,7,3,7,8,32
statues,1,0,1,0,0,2
speed,3,1,1,1,2,8
taxt,1,0,1,1,0,3
death,15,4,4,8,6,37
thinking,1,3,1,1,3,9
daydreaming,1,1,1,2,1,6
cumha,1,1,0,1,1,4
sportin,1,0,0,0,1,2
ilusao,0,1,0,1,1,3
choclate,1,1,0,0,1,3
treatment,0,0,0,0,1,1
verso,1,1,0,1,1,4
role,2,1,0,1,2,6
momentum,1,0,1,0,1,3
real,9,4,6,11,9,39
ditt,0,1,0,0,0,1
envie,1,0,0,0,0,1
rasta,1,0,0,1,1,3
rules,1,0,1,2,0,4
lado,2,0,0,0,0,2
gonna,19,18,12,9,16,74
gamelan,1,0,0,0,1,2
early,2,1,0,0,2,5
listening,1,1,1,0,1,4
earls,1,0,0,0,0,1
execution,1,1,0,1,0,3
lady,6,5,2,4,8,25
koobas,1,1,1,1,1,5
ruled,1,1,0,0,1,3
collapsar,1,1,1,1,1,5
fortune,1,0,0,0,1,2
pounds,0,0,1,0,0,1
greeting,1,1,1,0,1,4
miracle,2,1,3,2,2,10
oblivion,1,0,0,1,0,2
adianta,1,1,1,1,1,5
whatcha,2,0,1,1,2,6
morena,4,5,0,2,5,16
twelve,1,0,0,0,1,2
eddie,0,0,1,1,1,3
betania,0,1,0,0,1,2
ihmisen,1,0,1,1,1,4
recorded,1,1,0,1,0,3
guillaume,1,0,0,0,1,2
hustla,0,0,0,1,1,2
willie,3,1,1,2,2,9
hustle,0,0,0,0,1,1
ohios,1,0,1,1,1,4
business,4,1,1,4,3,13
sixth,1,0,1,1,1,4
neurtica,1,0,1,0,1,3
credits,1,0,1,0,0,2
artie,0,1,0,0,0,1
innocence,2,0,0,1,2,5
raul,2,1,0,1,2,6
francis,0,1,0,0,1,2
throw,1,1,1,2,1,6
brighton,0,1,0,0,0,1
aphrodite,1,0,1,0,0,2
central,1,1,1,1,1,5
lombrigas,1,1,1,1,1,5
chop,1,0,1,0,0,2
journey,2,3,0,2,5,12
assassin,1,0,1,1,0,3
sketches,0,1,0,0,0,1
mirame,0,1,0,1,1,3
youd,2,0,2,1,1,6
zambele,0,1,0,1,1,3
prospection,0,0,0,1,0,1
morir,0,0,0,1,1,2
bedtime,1,0,0,0,1,2
operator,2,2,1,1,2,8
your,92,55,46,77,76,346
semba,0,1,0,1,1,3
stare,2,1,2,2,0,7
area,0,0,0,0,1,1
weekend,1,0,0,0,0,1
start,9,1,4,3,6,23
ares,1,1,0,1,0,3
stars,8,3,6,7,9,33
shagi,0,0,0,1,1,2
copacabana,0,1,0,1,0,2
grandbags,1,0,1,1,1,4
caviglia,1,0,1,1,0,3
trying,2,2,0,0,2,6
stickin,1,0,0,0,1,2
porcelaine,1,1,1,1,1,5
opression,1,0,0,0,0,1
tellin,1,1,0,1,0,3
sadness,0,0,0,1,0,1
aneurysm,1,0,1,0,0,2
troyano,1,1,0,0,0,2
araby,1,1,0,1,1,4
tengo,0,0,0,0,1,1
mover,1,0,0,0,0,1
superconfidential,1,0,0,1,0,2
completeness,1,1,0,1,1,4
todo,4,2,2,3,4,15
songgreat,1,0,0,0,0,1
tirador,1,1,0,1,1,4
dimanche,1,1,0,0,2,4
fools,4,1,3,2,2,12
poor,3,2,2,1,3,11
diaries,1,1,1,0,1,4
yippiyoay,1,0,0,1,1,3
time,68,38,28,39,55,228
desclaves,1,1,0,1,1,4
pooh,0,1,0,0,0,1
airheads,1,0,1,1,1,4
pool,1,1,0,1,1,4
building,3,1,2,1,1,8
tacuta,1,0,0,1,0,2
volcn,0,0,0,1,1,2
moonlight,2,4,0,4,4,14
bystander,1,0,1,1,0,3
youngblood,1,1,0,1,1,4
offishall,0,1,0,0,1,2
parabolics,0,0,0,2,0,2
cruisin,1,1,0,1,1,4
decelerate,1,0,1,0,0,2
tomorrows,1,0,0,0,0,1
fleurs,1,1,0,1,1,4
govinda,1,1,0,1,1,4
ciudad,0,0,0,0,1,1
monts,0,1,0,0,1,2
corps,1,4,0,2,1,8
bosque,1,1,1,1,0,4
hablo,0,1,0,0,0,1
fountain,0,1,0,0,1,2
dekh,1,0,1,1,1,4
vers,2,1,1,2,1,7
bazooka,1,1,1,1,1,5
ventilador,1,1,0,1,1,4
witching,1,1,0,1,1,4
vera,1,1,0,1,1,4
rogue,1,1,0,1,1,4
decide,1,1,0,1,1,4
decidi,0,0,0,0,1,1
heaven,13,9,7,10,13,52
louis,1,1,0,0,1,3
nortena,1,0,0,0,1,2
locomotive,1,0,1,1,1,4
louie,2,0,2,1,0,5
colossal,1,0,1,0,0,2
streets,4,4,1,2,4,15
cibola,1,0,1,1,1,4
conscience,1,1,1,1,1,5
ails,0,0,0,1,0,1
apologizes,1,1,0,1,0,3
darkness,4,2,3,3,3,15
consumers,1,1,1,1,0,4
nana,2,1,0,0,1,4
maybes,1,1,0,1,0,3
onni,1,1,1,1,1,5
learned,1,0,1,0,0,2
edited,4,2,0,3,6,15
unuturum,0,0,0,0,1,1
sarankgni,0,1,0,1,1,3
loose,3,0,1,2,2,8
answers,3,1,2,2,3,11
tracks,1,0,1,0,0,2
signapur,1,0,0,0,0,1
brillantin,1,1,0,1,1,4
meisten,0,0,0,0,1,1
strong,2,0,0,0,1,3
arena,2,2,1,1,2,8
ahead,1,0,1,0,0,2
perfidia,0,1,0,0,1,2
reason,4,1,2,1,3,11
soldier,1,0,1,0,1,3
coeurs,1,1,0,1,1,4
tralala,1,1,0,0,1,3
shuffle,5,4,0,4,4,17
family,1,0,0,2,3,6
setanta,1,1,0,1,1,4
khan,0,0,1,1,1,3
takes,8,4,3,2,8,25
amaze,0,0,0,2,0,2
pantin,1,1,0,0,1,3
taken,1,0,0,0,0,1
remixes,1,0,0,2,1,4
instrumental,16,12,7,12,11,58
excuse,1,1,0,1,1,4
broke,4,1,2,1,2,10
dios,1,1,0,2,2,6
hurry,3,1,3,3,2,12
brokn,1,0,1,0,0,2
grill,0,0,0,0,1,1
legba,1,1,0,1,1,4
nina,2,2,2,2,3,11
minhas,1,1,0,0,1,3
nine,2,0,1,2,1,6
hermione,1,1,0,0,0,2
nino,0,1,0,1,2,4
history,4,1,1,1,1,8
albi,0,0,1,1,1,3
sharab,0,0,0,0,1,1
albo,1,1,0,1,1,4
dragonfly,2,0,1,0,0,3
veinte,0,1,0,1,1,3
daddys,1,1,1,1,1,5
chagallos,0,0,0,0,1,1
cows,1,0,1,1,1,4
phrase,1,1,0,1,1,4
zanzibar,1,0,0,0,0,1
liebe,0,0,1,1,0,2
warhead,1,0,0,0,0,1
limosna,0,0,0,1,1,2
stayed,1,1,0,1,1,4
snippet,1,0,1,0,0,2
calme,0,0,0,1,1,2
paloma,0,0,0,0,1,1
eterno,1,0,0,1,1,3
rude,0,0,0,1,0,1
santilln,1,1,0,0,0,2
tries,1,1,0,1,0,3
invasion,1,1,0,1,1,4
rudy,1,3,0,3,0,7
compulsory,0,0,1,0,0,1
anytime,1,0,0,0,2,3
dread,0,0,0,1,0,1
dream,24,12,15,17,19,87
penda,0,0,0,0,1,1
help,10,3,4,8,8,33
nightsoftly,1,1,0,0,1,3
soon,2,1,1,1,1,6
held,0,1,0,0,1,2
soot,1,1,1,1,1,5
hell,12,3,6,3,8,32
markie,1,1,1,1,0,4
prowler,1,0,0,1,1,3
arbolitos,1,1,0,1,1,4
cloches,1,0,0,1,1,3
friscia,1,0,0,1,1,3
absence,0,0,0,1,0,1
lontana,1,0,0,0,1,2
peanuts,0,2,0,1,1,4
fool,6,2,1,3,3,15
evening,2,3,0,2,3,10
food,2,2,0,1,2,7
foot,1,1,0,1,0,3
ninja,3,1,2,3,3,12
hammersmith,1,0,0,1,1,3
cadenza,1,0,0,1,1,3
fully,1,1,1,1,0,4
bless,1,3,1,1,2,8
decimas,1,0,0,1,1,3
roadage,1,0,0,0,0,1
mewith,1,1,0,1,1,4
restless,0,1,0,1,0,2
hiroteros,0,0,0,0,1,1
toda,0,1,0,0,1,2
quantum,1,0,1,1,0,3
infinity,3,1,1,3,2,10
neir,1,0,0,1,1,3
beyond,4,2,2,2,1,11
conker,0,0,0,1,0,1
anarchy,1,0,0,0,0,1
vertigo,1,1,1,1,1,5
basements,1,0,0,1,1,3
miss,7,2,6,4,4,23
robert,2,1,0,1,1,5
since,3,2,2,2,3,12
chiove,1,0,0,0,0,1
testify,1,0,1,1,1,4
wolverine,1,1,0,0,1,3
pemba,0,1,0,0,0,1
safety,1,0,1,0,0,2
shuncata,0,0,0,0,1,1
drink,1,1,0,2,1,5
rednosed,1,1,0,1,1,4
bass,5,1,4,5,2,17
dirt,1,1,0,0,0,2
mentimos,0,0,0,0,1,1
dune,0,1,0,1,1,3
tipota,0,0,0,0,1,1
brightess,0,1,0,1,0,2
ironhead,0,0,1,0,1,2
selon,0,0,0,1,0,1
montagnes,1,1,0,0,1,3
gwithian,1,1,0,1,0,3
gonewine,0,0,0,0,1,1
kazmeyer,1,1,1,1,1,5
terrible,1,1,0,1,1,4
americas,1,0,1,0,1,3
bancate,1,0,1,1,1,4
american,7,3,3,4,5,22
daisy,1,0,0,1,1,3
heartbeat,1,0,0,0,0,1
xiang,0,0,0,1,4,5
malki,1,0,1,1,1,4
knots,1,1,1,1,0,4
ville,1,0,0,0,0,1
kaliforneyea,1,1,0,0,0,2
coloreteada,1,0,0,0,1,2
mist,1,1,0,1,1,4
visions,3,4,2,4,2,15
rorys,1,1,1,1,1,5
horse,6,1,2,0,5,14
pinned,1,0,1,0,0,2
eddy,0,0,0,0,1,1
station,2,1,0,2,1,6
gibraltar,1,0,1,0,1,3
handshakes,1,0,1,0,1,3
nigeria,0,0,0,1,1,2
banana,1,1,0,1,0,3
selling,1,1,0,0,0,2
trapped,0,0,0,1,0,1
norma,0,0,0,1,0,1
jamie,2,2,1,2,1,8
magali,1,1,0,1,1,4
overdrive,1,0,1,0,1,3
jordan,0,1,0,0,1,2
shifter,1,0,1,1,1,4
authors,1,0,0,0,0,1
translation,1,0,0,1,0,2
lament,6,3,2,4,5,20
grey,1,0,0,0,1,2
vitalized,1,0,1,0,0,2
maga,1,0,0,0,1,2
izgaryam,1,0,0,0,1,2
mahmouds,0,1,0,0,0,1
humppa,3,2,2,2,2,11
apagon,1,0,1,1,1,4
juice,1,0,0,0,1,2
eternamente,0,0,0,0,1,1
bubulina,1,0,1,1,1,4
poulet,1,0,1,1,1,4
ultrafunk,1,1,1,1,1,5
jour,1,1,1,1,1,5
cherokee,1,0,1,0,0,2
trance,1,1,1,1,1,5
cave,2,2,0,3,2,9
cava,1,1,0,1,0,3
tinghi,1,1,1,1,0,4
nuestras,0,0,0,0,1,1
towards,1,0,1,1,0,3
appapas,1,1,0,1,1,4
freddie,2,2,0,2,2,8
aires,1,0,0,0,1,2
aljarafe,1,0,0,1,1,3
alpha,1,1,0,1,1,4
mack,1,1,0,0,1,3
beachport,1,0,1,1,1,4
minha,0,1,0,0,1,2
clear,1,0,1,3,3,8
blent,0,0,0,0,1,1
ziggy,1,0,0,0,1,2
clean,3,0,0,0,1,4
hips,1,0,0,0,1,2
ekloges,1,0,0,1,1,3
danza,1,1,0,1,0,3
ingenting,1,1,1,1,1,5
sheik,1,1,0,1,1,4
garantito,0,0,1,1,0,2
crayon,1,1,0,1,1,4
heavens,3,1,0,0,2,6
blackwords,1,0,1,1,0,3
northern,1,0,1,0,1,3
justice,1,0,0,0,0,1
less,2,1,2,3,1,9
quem,0,1,0,1,1,3
randy,1,1,1,1,1,5
pretty,6,2,5,3,4,20
hardened,1,0,1,1,1,4
circle,3,3,2,2,3,13
bigbigkiss,1,0,1,1,1,4
trees,4,4,2,3,4,17
strut,1,0,0,0,0,1
famous,2,0,2,1,2,7
feels,2,2,0,2,3,9
during,1,1,0,2,0,4
molten,0,0,0,1,0,1
catcher,1,0,1,1,1,4
graysinn,1,0,0,1,0,2
vingt,1,1,0,0,1,3
geld,1,0,0,1,1,3
regreses,0,0,0,1,1,2
seventeen,1,0,1,1,2,5
backtrack,1,1,0,0,0,2
throwing,1,0,0,0,1,2
plough,0,1,0,1,0,2
ctait,1,1,0,1,1,4
culture,1,0,1,1,0,3
bethlehem,1,1,0,1,1,4
portrait,1,2,2,0,0,5
angie,1,0,0,0,1,2
pish,1,0,0,1,1,3
termites,0,0,0,1,1,2
bride,1,1,0,1,1,4
pictures,1,1,1,0,1,4
enger,1,0,0,0,0,1
engel,1,1,1,1,1,5
stall,1,0,0,1,1,3
marcando,1,0,0,0,1,2
tappin,1,0,1,0,1,3
deil,0,1,0,1,0,2
piss,1,0,0,0,0,1
missing,6,1,2,6,2,17
dejaria,0,1,0,0,0,1
invisible,1,0,0,0,1,2
speilet,0,1,0,0,0,1
cassard,0,1,0,0,1,2
secrets,1,0,0,1,1,3
perkiomen,1,0,0,0,1,2
anos,0,0,0,0,1,1
keybdbpremiere,1,0,1,0,1,3
remastering,0,0,0,0,2,2
halintamyymln,1,0,1,1,1,4
forgotten,2,1,0,1,1,5
hbar,1,0,1,1,1,4
hackers,1,0,0,1,0,2
battery,0,1,0,1,0,2
steele,1,1,0,0,1,3
whatever,2,0,2,1,1,6
quiera,0,1,0,0,0,1
capleton,1,1,0,1,0,3
likes,1,1,0,1,1,4
sailboat,0,1,0,0,1,2
celluloid,1,0,0,0,1,2
fabolous,1,0,0,0,1,2
destructor,1,0,1,1,0,3
wasnt,1,0,0,0,0,1
damn,2,0,1,1,2,6
militar,1,0,1,1,1,4
empty,4,1,1,2,2,10
dame,2,2,0,2,2,8
dialogue,3,1,0,0,1,5
lived,0,0,0,1,0,1
chimrique,1,1,0,1,1,4
chasseurs,1,1,0,1,1,4
abajo,0,0,0,1,1,2
else,1,0,1,0,1,3
katherine,1,0,0,0,1,2
heute,1,0,1,1,0,3
peyote,1,0,1,1,1,4
envers,1,1,1,1,1,5
valkyria,1,0,0,1,0,2
look,8,6,3,3,8,28
bikini,1,0,0,1,1,3
ropa,1,0,0,0,1,2
chariots,1,1,0,1,1,4
luciano,2,1,1,2,2,8
alte,1,1,1,1,1,5
loop,4,3,2,4,3,16
pack,1,0,0,3,3,7
lagan,0,0,0,1,0,1
pantera,1,0,1,1,1,4
wildflowers,1,0,0,0,1,2
smacker,0,1,0,1,0,2
ready,4,2,1,7,5,19
guido,1,0,0,1,1,3
orfvres,1,0,1,1,1,4
anymore,6,1,1,3,5,16
terras,2,2,0,2,2,8
dormilones,0,1,0,0,1,2
subliminal,1,1,0,1,0,3
syleena,0,0,0,0,1,1
grand,3,5,2,4,4,18
estes,1,0,1,0,0,2
drmmen,0,1,0,0,0,1
composition,1,1,1,1,1,5
used,2,2,1,1,2,8
dime,1,1,0,1,2,5
bonus,17,4,4,12,11,48
haunting,2,0,0,1,1,4
adrift,1,0,0,0,1,2
yuan,0,0,0,0,1,1
older,1,1,1,1,1,5
obviously,1,0,0,0,0,1
five,5,5,1,3,3,17
coup,1,1,1,2,2,7
cour,1,1,0,1,1,4
choro,1,2,1,2,2,8
sovra,1,0,0,1,0,2
praying,1,1,0,0,1,3
afro,1,0,1,1,1,4
caray,2,0,1,1,2,6
nikki,1,1,1,1,1,5
carat,1,1,0,1,1,4
cheryl,0,1,0,1,0,2
soliloquy,0,1,0,0,1,2
march,4,4,1,2,5,16
marca,1,1,0,1,1,4
albino,1,0,1,0,0,2
game,4,4,1,4,3,16
dearly,1,1,0,0,1,3
wings,4,3,4,3,5,19
laccordoniste,1,1,1,1,1,5
mantrol,1,1,1,1,0,4
superbird,1,1,1,1,1,5
baari,1,0,0,1,1,3
weinen,1,1,0,1,1,4
signal,0,0,0,1,0,1
donny,0,1,0,1,0,2
donne,0,0,0,1,1,2
suitcase,1,0,0,0,1,2
cones,0,0,1,0,0,1
brampton,2,1,1,2,1,7
autres,3,2,0,2,3,10
creation,2,1,1,2,2,8
some,12,6,6,6,11,41
osorio,1,0,0,1,1,3
lips,1,0,1,0,0,2
fanfara,1,1,0,1,1,4
debri,1,0,0,1,0,2
civilization,1,0,0,0,0,1
winterlight,0,1,0,1,0,2
bladecrash,1,1,1,1,1,5
squirrel,1,1,0,1,0,3
eruption,1,0,0,0,1,2
processing,1,0,1,1,1,4
lakes,1,1,0,0,0,2
jazzy,0,1,0,0,1,2
step,7,3,2,3,4,19
panhandle,1,0,1,0,1,3
contessa,0,1,0,1,0,2
shine,4,5,1,2,4,16
faith,4,1,0,1,3,9
padam,0,2,0,0,2,4
wouldnt,3,1,1,1,2,8
bleue,0,0,0,1,1,2
yiri,2,0,0,2,0,4
bloco,0,1,0,0,0,1
shiny,1,0,0,0,0,1
silence,5,0,3,3,2,13
seeing,1,0,0,0,1,2
visit,1,0,0,1,1,3
crying,3,2,2,2,2,11
grella,0,0,0,1,0,1
rolls,1,1,0,1,1,4
heritage,1,0,0,1,1,3
kamikaze,1,0,1,1,1,4
bossa,0,1,0,1,0,2
brazos,1,1,0,0,0,2
authority,1,0,0,0,1,2
reef,0,1,0,0,0,1
russian,1,1,1,0,1,4
skull,1,0,0,0,0,1
accustomed,2,2,2,0,2,8
conguitos,0,1,0,0,1,2
loving,11,6,5,9,11,42
chelsea,1,1,1,1,1,5
necesito,0,0,0,0,1,1
moonless,0,0,0,2,0,2
selfhelp,1,1,0,1,0,3
psychopath,1,0,0,0,0,1
cotton,1,0,0,1,0,2
varga,0,0,0,1,0,1
jamboree,0,0,0,0,1,1
objection,1,0,0,0,1,2
creeper,1,0,1,1,1,4
prerogative,1,0,0,1,1,3
recordar,1,0,0,1,0,2
beholder,1,0,0,0,0,1
zither,0,1,0,1,0,2
smiles,1,1,1,1,0,4
everybodys,5,3,2,1,3,14
vivace,1,0,0,1,2,4
william,1,0,0,1,0,2
drag,1,0,1,0,0,2
wohr,1,0,0,1,1,3
naheen,0,0,0,1,0,1
neill,1,1,0,1,1,4
druzya,0,0,0,1,1,2
mentira,2,0,1,1,2,6
beholden,1,1,0,0,1,3
katz,1,1,1,1,1,5
washy,1,1,0,0,0,2
dreidel,4,0,4,0,0,8
psyche,1,1,0,1,0,3
wakabam,1,1,1,1,1,5
marchant,0,1,0,1,0,2
aria,1,0,0,1,1,3
gorilles,0,0,0,1,1,2
nose,1,0,1,0,1,3
does,4,1,1,0,4,10
suite,4,3,1,3,3,14
virtuous,0,0,0,1,0,1
murderous,0,0,0,1,1,2
springpart,0,1,0,0,0,1
wave,5,1,1,4,3,14
cellular,1,0,1,1,1,4
telling,1,0,0,0,1,2
bravest,0,0,0,0,1,1
stiff,1,0,1,1,1,4
button,1,1,0,0,1,3
tokyo,2,0,0,2,0,4
michael,4,2,0,3,3,12
sannyasin,1,0,0,0,1,2
barbara,0,1,0,0,0,1
oopsi,1,0,0,1,1,3
booty,0,0,0,1,0,1
boots,2,0,0,0,2,4
dormire,1,0,0,0,1,2
jump,6,5,4,3,5,23
booth,1,1,0,0,0,2
picked,3,0,2,3,0,8
colonel,1,1,1,1,1,5
sangria,0,1,0,0,1,2
cell,3,0,2,1,1,7
rotten,1,1,1,1,1,5
playa,0,0,0,1,1,2
grenouilles,0,1,0,0,0,1
cela,0,0,0,1,0,1
stance,1,1,0,1,1,4
commercial,2,2,2,2,2,10
chant,2,1,0,2,2,7
coracao,1,1,0,0,0,2
biter,1,0,1,0,0,2
peyte,1,0,0,1,0,2
geng,0,0,0,0,1,1
nameless,1,0,1,1,1,4
salvation,1,0,1,2,0,4
claro,1,1,1,0,1,4
daybreak,0,0,0,1,0,1
clark,1,1,0,0,0,2
lords,0,1,0,0,0,1
clare,0,2,2,0,0,4
mcdermotts,0,0,0,2,0,2
singing,1,1,0,0,1,3
burbullas,0,0,0,1,0,1
cloud,2,2,1,3,2,10
redwing,1,1,0,1,1,4
snoop,0,0,0,0,1,1
remains,2,2,2,1,2,9
crab,1,0,0,0,0,1
zornig,0,0,0,1,0,1
pickney,1,0,0,1,1,3
poppea,1,0,0,0,1,2
started,0,0,0,2,2,4
confused,1,0,0,0,0,1
vuelta,1,0,0,0,0,1
biblicas,0,0,0,0,1,1
justin,3,1,0,0,3,7
crosses,0,0,0,1,0,1
aamutoimet,1,0,1,1,1,4
huesos,0,1,0,1,1,3
ride,13,7,8,9,10,47
crossed,0,0,0,1,0,1
meet,4,1,1,2,4,12
control,8,3,6,2,5,24
votre,0,1,0,0,0,1
halloween,2,0,0,1,3,6
pulling,0,0,0,0,1,1
heut,1,1,1,1,1,5
wonderful,3,4,1,4,3,15
kenna,1,0,1,0,1,3
langem,1,0,1,1,1,4
theydon,1,1,1,1,1,5
talar,1,0,0,1,0,2
vibe,0,1,0,0,0,1
chevrolet,1,0,0,0,1,2
clair,1,0,0,2,2,5
frontiers,1,1,1,1,1,5
gritos,1,1,0,0,0,2
knnykk,1,0,0,1,1,3
thtre,1,1,0,1,1,4
introchamber,1,0,0,0,1,2
valokeilojen,1,0,1,1,1,4
farm,3,2,2,2,0,9
bettinghaus,1,0,1,1,1,4
sewell,1,1,0,0,0,2
spelling,0,1,0,1,0,2
scoob,0,0,1,1,0,2
ramblin,0,0,1,0,0,1
xenophobic,1,0,1,0,1,3
samaritanas,0,0,0,0,1,1
corral,1,0,0,0,1,2
raliste,0,0,0,0,1,1
vapauden,1,0,0,1,1,3
weiners,0,0,0,1,0,1
unbreakable,0,1,0,0,1,2
harajuku,1,0,0,0,1,2
spero,0,0,0,0,1,1
slickers,1,0,0,1,0,2
cuestion,0,0,0,0,1,1
calliope,1,1,0,1,1,4
outer,1,0,0,0,0,1
broom,1,0,0,1,1,3
dancin,1,1,1,1,1,5
cavalleria,1,1,1,1,1,5
takao,1,1,0,1,1,4
doodlin,0,1,0,0,0,1
lindas,1,1,1,1,1,5
breezin,0,0,0,0,1,1
camino,1,0,0,1,1,3
lightnin,1,1,0,0,1,3
placid,0,0,0,2,0,2
hands,6,3,3,4,8,24
sweety,1,1,0,1,1,4
handz,1,1,0,1,1,4
plecaciunea,1,0,0,1,0,2
masters,1,0,0,0,0,1
rahzel,0,1,0,0,1,2
university,2,0,0,2,2,6
hootchie,1,0,0,1,0,2
hacer,2,0,0,0,3,5
candela,1,2,0,1,1,5
blarneyformasian,1,0,1,1,0,3
splitloop,1,0,0,1,0,2
illuminate,0,0,0,1,0,1
warten,1,1,1,1,1,5
baroudeur,1,1,0,1,1,4
sands,1,1,1,1,1,5
morton,0,1,0,0,1,2
special,9,4,5,7,7,32
ricks,1,0,0,1,0,2
fathom,1,1,0,1,1,4
ricky,1,0,0,0,1,2
hardway,0,0,0,1,0,1
chatma,1,0,1,0,0,2
wich,1,1,1,1,2,6
umbrella,2,0,0,1,2,5
flamme,1,1,0,0,1,3
marea,1,0,1,1,1,4
interplanetary,1,1,0,0,1,3
segredo,1,1,0,0,0,2
wizard,0,1,0,0,1,2
negros,0,0,0,0,1,1
printemps,1,2,0,0,2,5
princess,1,0,0,1,0,2
drowning,1,0,1,0,0,2
route,1,0,1,1,0,3
gallina,1,0,0,0,1,2
keep,11,9,5,10,13,48
stride,1,0,0,1,0,2
complainingremixjam,1,0,0,0,1,2
kitteldags,1,0,0,1,1,3
svedomi,1,1,1,0,1,4
buckle,1,1,1,0,1,4
bambenella,0,0,0,0,1,1
sonnenfreunde,0,0,0,1,0,1
congo,1,1,0,0,1,3
bitch,2,1,2,2,2,9
sosa,1,0,0,0,0,1
quality,1,1,1,0,1,4
hiding,2,0,0,0,1,3
fella,1,0,1,1,0,3
bears,1,0,0,0,1,2
africanas,1,1,1,1,1,5
wrapper,1,0,0,1,0,2
foldiv,0,0,0,1,0,1
boken,1,0,0,0,0,1
quieras,0,0,0,1,2,3
wrapped,1,0,0,0,1,2
final,6,4,2,5,9,26
frustration,1,1,1,1,1,5
urbania,0,0,0,0,1,1
huan,0,0,0,0,1,1
listo,1,0,1,0,0,2
dyna,0,1,0,1,1,3
masking,1,0,1,1,0,3
waist,0,0,0,1,0,1
splendido,1,1,0,1,1,4
damaja,0,1,0,0,0,1
assouf,1,0,1,0,0,2
dumb,2,2,1,1,2,8
kitties,1,0,1,1,1,4
drunk,2,1,1,2,1,7
close,5,3,3,5,6,22
need,23,13,13,19,20,88
sacre,0,1,0,0,0,1
sacra,0,1,0,1,0,2
dolorosa,1,0,1,1,1,4
bastard,1,0,0,0,0,1
enqute,1,0,0,1,1,3
jaunt,0,1,0,0,0,1
singe,1,0,0,1,1,3
singh,1,0,1,1,1,4
brand,0,0,0,0,1,1
discos,0,0,0,1,0,1
intentions,2,0,1,0,2,5
duele,1,1,0,0,0,2
kanaria,1,0,0,1,1,3
lultimo,1,0,0,0,1,2
stereo,3,1,2,3,2,11
beatnuts,0,1,0,1,0,2
upset,1,1,0,1,1,4
silenzio,1,1,1,1,1,5
astonishing,1,0,1,0,1,3
kaloobafak,1,0,0,0,1,2
snapshot,1,0,1,1,1,4
indo,0,0,0,1,1,2
wagoners,1,0,0,0,1,2
hitaat,1,0,1,1,1,4
desiluso,1,1,0,0,1,3
anyway,1,0,0,1,1,3
poesa,1,0,1,1,1,4
doigts,1,0,1,1,1,4
soldiers,1,0,0,0,0,1
lowlands,1,1,1,0,1,4
serpentarius,0,0,0,1,0,1
unfinished,1,2,0,1,1,5
acension,1,1,1,1,0,4
brighten,1,0,0,0,1,2
arabian,1,0,1,1,1,4
creamer,0,0,0,1,0,1
libre,1,1,0,1,1,4
fuel,1,1,0,0,0,2
infernal,0,0,1,0,0,1
heartshaped,1,0,1,0,0,2
collinerodolfoschaunardchildrentownspeoplemusetta,0,1,0,0,0,1
lynn,0,0,0,0,1,1
deine,0,0,1,1,0,2
exaltation,1,0,1,0,1,3
murphey,1,1,0,1,0,3
joint,1,1,1,1,1,5
leben,1,1,1,1,1,5
years,5,2,2,2,1,12
borin,1,0,0,0,0,1
endless,4,0,2,1,1,8
evolution,1,0,1,1,1,4
tobacco,1,0,1,0,0,2
gras,2,2,0,0,2,6
benzer,0,1,0,0,1,2
gran,2,0,0,1,1,4
dangerous,2,1,1,1,2,7
grad,3,1,1,2,3,10
grae,1,0,0,1,1,3
preach,1,0,0,0,1,2
gillum,0,1,0,0,0,1
mewerthercharlotte,0,1,0,0,0,1
nuttin,0,0,0,1,0,1
prayers,0,1,0,0,0,1
faroe,0,1,0,1,0,2
pitch,1,1,0,1,1,4
tromorckbank,1,1,1,1,0,4
shaan,1,1,1,1,1,5
freeze,2,1,1,1,2,7
humano,0,1,0,1,0,2
computer,2,1,0,2,2,7
desperate,1,0,0,0,1,2
sensualite,0,0,0,1,0,1
danger,2,0,0,0,0,2
skylark,0,1,0,1,1,3
nightmare,2,0,0,0,0,2
dundee,0,1,0,1,1,3
remembergreat,1,1,1,1,1,5
state,2,1,0,1,2,6
caja,0,1,0,0,1,2
joyo,1,0,0,0,1,2
tyre,1,1,0,1,1,4
horrible,1,0,1,1,1,4
sabotage,1,0,0,0,0,1
llamado,0,0,0,0,1,1
dogon,0,0,0,1,0,1
buckets,1,1,0,0,0,2
kicking,1,0,0,0,0,1
merry,3,4,1,2,4,14
approval,1,0,1,0,0,2
precious,3,3,0,1,3,10
sextetgilded,1,1,0,1,0,3
solace,1,0,0,1,0,2
fishin,2,2,0,0,2,6
hits,1,0,1,1,1,4
beenie,1,1,1,1,1,5
career,3,2,3,2,2,12
minds,1,0,1,0,1,3
subcode,1,1,1,1,0,4
mudhump,1,1,1,1,0,4
dominique,1,1,0,0,1,3
tuesday,1,2,0,1,1,5
harmonic,1,1,1,1,1,5
harmonia,2,0,0,2,0,4
denise,2,2,2,2,0,8
freaxxx,1,0,1,1,1,4
kings,1,1,0,0,1,3
wyclef,1,0,0,0,2,3
erased,1,0,0,1,1,3
quit,2,1,0,1,1,5
stompin,0,1,0,1,1,3
polka,1,2,0,0,1,4
cent,2,1,1,2,2,8
slowly,2,0,2,1,2,7
treat,2,1,1,2,2,8
whisper,1,1,0,0,1,3
ship,2,3,0,2,3,10
mdchen,1,1,0,1,1,4
senses,1,0,0,0,1,2
oversleeping,1,1,0,1,1,4
trebraruna,1,0,0,0,0,1
shameless,1,0,0,1,1,3
bahama,0,1,0,0,0,1
harder,1,1,0,1,1,4
chamar,1,1,1,1,1,5
tuggathanug,0,0,0,1,0,1
rudedrum,1,1,1,1,1,5
enamorate,1,1,0,1,1,4
simons,1,0,0,1,0,2
demo,20,7,9,8,9,53
aurle,1,1,0,1,1,4
swinging,2,2,0,1,2,7
hearted,3,1,1,2,3,10
bucks,1,1,1,1,1,5
goodfellas,0,1,0,0,0,1
shooting,1,0,1,0,2,4
parte,1,0,0,0,1,2
chante,1,0,0,0,0,1
balloon,0,0,0,0,1,1
parto,2,2,0,2,3,9
strange,4,4,1,3,4,16
speaker,0,0,0,1,1,2
underground,1,0,1,1,1,4
party,17,7,9,11,14,58
buzz,0,1,0,0,0,1
nightly,1,0,0,1,1,3
paechar,1,1,0,1,1,4
magician,1,1,0,1,0,3
isch,1,1,1,1,0,4
destruction,3,1,1,3,3,11
poultry,0,0,0,1,0,1
obstacles,1,0,0,0,0,1
well,6,4,1,5,3,19
guidum,0,1,0,0,0,1
senza,1,0,1,0,0,2
onda,1,0,1,1,1,4
underdog,2,0,1,1,2,6
flies,2,1,2,2,2,9
distant,1,4,0,3,1,9
laurel,0,0,0,0,1,1
devient,1,0,1,1,1,4
femme,1,1,1,0,2,5
tontos,1,0,0,0,1,2
fasttrack,1,1,1,1,1,5
stratus,1,0,1,0,0,2
vida,4,5,1,5,5,20
patricia,1,1,1,0,1,4
reasons,1,1,0,0,1,3
atrapado,1,1,0,1,1,4
kick,4,2,3,1,3,13
jesper,1,0,0,0,0,1
livin,8,5,4,4,4,25
fate,1,1,0,0,1,3
crushed,0,0,1,1,0,2
amthran,0,1,0,0,0,1
burden,2,0,1,1,2,6
guerrier,1,1,0,0,1,3
lincoln,1,1,0,0,1,3
renegade,1,0,1,1,1,4
lost,16,4,6,13,10,49
fingerprints,1,0,1,1,1,4
fernando,1,1,0,1,1,4
candy,1,1,1,1,0,4
peixes,1,1,0,1,0,3
lose,5,3,3,2,2,15
japjit,0,1,0,1,0,2
rote,1,1,1,1,1,5
regresar,1,0,0,0,1,2
seigneur,0,1,0,1,0,2
retrato,0,0,0,1,0,1
hush,0,1,0,0,1,2
francisco,1,2,1,2,3,9
shes,14,6,5,3,6,34
shep,1,1,0,0,1,3
cleveland,2,0,0,1,2,5
voadora,0,0,0,1,0,1
petes,0,2,0,2,2,6
heartache,1,1,1,1,1,5
filero,1,1,0,1,1,4
broad,1,0,1,1,1,4
kettle,1,0,0,0,0,1
hannos,1,1,0,1,1,4
cradle,1,0,0,1,1,3
wendy,1,1,1,0,1,4
desejos,1,1,0,1,1,4
tides,1,0,1,0,0,2
coated,1,1,0,2,1,5
reaching,1,1,0,1,1,4
puede,1,0,1,0,1,3
tarha,1,1,1,1,0,4
bundle,1,1,0,0,1,3
refuge,1,0,1,0,1,3
macleods,1,0,0,0,0,1
freedom,5,1,2,2,7,17
madame,1,1,0,0,1,3
compatible,0,0,0,0,1,1
unbreak,2,0,0,1,2,5
tongue,1,0,0,1,1,3
accapella,1,0,0,1,1,3
chulo,1,0,0,1,1,3
pistols,1,0,0,0,0,1
previously,3,1,2,0,2,8
washington,1,1,0,0,1,3
sadiko,0,0,0,0,1,1
crumbsnatchers,1,1,1,1,1,5
cocoa,1,1,1,1,0,4
couldnt,3,0,1,0,1,5
tabernacle,1,0,1,0,0,2
jing,2,0,0,2,3,7
machopolka,1,1,0,1,0,3
dolores,0,0,0,0,1,1
claras,1,1,0,1,0,3
imperial,1,2,0,0,1,4
synthesizer,1,1,0,1,1,4
afrika,1,1,0,1,1,4
inner,3,1,1,2,1,8
mohair,1,1,1,1,1,5
prophetic,1,0,1,1,0,3
north,2,1,0,2,2,7
bodyfly,0,1,0,1,0,2
jubilation,1,1,0,1,1,4
nobodys,1,0,0,0,1,2
gail,0,1,0,1,0,2
ultimo,1,0,0,0,1,2
brick,2,0,2,2,1,7
dama,0,0,0,0,1,1
rumba,1,1,0,2,2,6
svartr,1,0,0,1,0,2
cella,1,0,0,1,1,3
walter,1,0,1,1,1,4
penny,1,0,1,0,1,3
twist,4,4,1,1,2,12
beats,2,2,1,2,1,8
claraazusa,1,1,0,1,1,4
mejor,0,0,0,0,1,1
kissed,1,1,0,1,1,4
eric,1,0,1,1,1,4
pussycat,0,1,0,0,0,1
keogh,1,1,1,1,1,5
meteor,0,0,0,0,1,1
katies,1,0,1,0,1,3
talkin,4,1,1,2,2,10
motivator,1,0,1,1,0,3
allstars,1,0,1,1,1,4
fois,2,1,2,1,1,7
stay,9,8,4,9,9,39
backstage,1,1,0,1,1,4
pathways,1,0,0,1,0,2
traxx,0,0,0,1,0,1
stan,1,0,1,0,1,3
pinup,1,1,1,1,1,5
friends,8,5,2,5,6,26
coya,1,0,0,0,1,2
martin,2,1,2,1,3,9
extrao,3,0,0,1,3,7
lives,1,0,0,0,0,1
alkohol,1,1,1,1,0,4
prfrence,1,1,0,1,1,4
phunk,1,0,0,1,1,3
dynamix,0,1,0,1,0,2
captain,3,2,1,2,4,12
auprs,1,1,0,0,1,3
buddy,1,3,0,1,0,5
poco,0,0,0,0,2,2
swan,1,0,1,2,1,5
sweetest,4,2,0,0,4,10
dontchaletmecatchya,0,0,0,0,1,1
sorry,1,0,1,1,2,5
fists,1,0,0,0,0,1
rescue,2,1,0,2,1,6
downstream,1,1,0,1,1,4
void,2,1,0,2,0,5
kutcha,0,1,0,0,0,1
smack,1,0,1,0,0,2
georgia,1,0,0,0,1,2
voix,1,0,0,0,1,2
confederate,1,0,1,1,0,3
voir,1,1,0,1,1,4
pilgrim,1,0,0,0,1,2
sangre,2,0,2,1,3,8
operette,0,0,0,0,1,1
prohibido,0,0,0,1,0,1
dagens,0,0,0,1,0,1
frre,1,1,0,1,1,4
dpenaills,1,1,1,1,1,5
washout,1,0,0,1,0,2
clothes,2,0,1,2,3,8
force,2,2,0,1,2,7
dennen,1,1,0,0,1,3
histoire,2,1,1,1,2,7
canela,0,0,0,0,1,1
japanese,1,0,1,1,1,4
crave,1,0,1,0,0,2
olvido,1,0,0,0,1,2
fixin,1,1,0,0,0,2
even,1,1,0,0,1,3
fugs,1,0,0,0,0,1
tipo,0,1,0,1,0,2
wreck,1,1,1,1,0,4
orchestre,0,0,0,0,1,1
hate,7,3,3,3,6,22
panama,2,0,0,0,2,4
orchestra,1,1,0,0,1,3
while,4,3,1,1,2,11
lights,4,2,2,3,3,14
cheng,1,0,0,0,1,2
ever,12,12,7,6,16,53
mamas,1,0,0,0,1,2
million,2,1,1,2,3,9
never,39,20,15,26,32,132
meurt,1,0,1,1,0,3
nicht,4,2,2,3,4,15
active,1,0,0,1,0,2
tapes,2,1,0,0,1,4
jams,2,0,2,0,1,5
fked,1,0,0,0,0,1
jsuis,1,1,1,1,1,5
guide,1,0,0,0,1,2
omar,0,0,0,1,1,2
prolog,1,0,0,1,0,2
reste,1,1,0,1,1,4
fantastic,1,1,0,0,1,3
digitally,7,4,1,4,6,22
weevil,1,2,0,0,0,3
county,1,1,0,1,1,4
ninety,1,0,0,0,0,1
menuet,0,1,0,0,0,1
landscape,0,0,1,0,0,1
army,2,2,1,3,1,9
arms,7,2,3,2,6,20
calabar,1,1,0,1,1,4
call,19,11,6,14,14,64
calm,3,0,1,2,3,9
tell,19,8,6,13,17,63
oscar,1,0,0,0,0,1
wars,1,0,0,0,0,1
tahitian,1,1,0,1,1,4
warm,1,0,1,1,1,4
frenzy,1,1,0,1,0,3
room,7,4,7,5,9,32
rights,3,1,1,1,1,7
roof,2,1,1,2,1,7
movies,5,3,3,1,6,18
foliage,1,1,1,1,1,5
dunno,1,0,0,0,0,1
kumal,1,1,0,1,1,4
give,22,8,6,14,12,62
climax,2,1,1,2,2,8
honey,2,1,1,1,5,10
karola,1,1,1,1,1,5
frieda,0,1,0,0,1,2
unforgettable,1,0,0,1,1,3
satu,1,1,0,0,1,3
january,1,0,4,0,3,8
principe,0,1,0,1,2,4
amazing,6,6,2,4,6,24
answer,3,0,1,3,2,9
stille,1,0,0,1,1,3
quoi,1,0,0,0,1,2
quon,0,0,0,1,0,1
apartes,1,0,0,0,1,2
cadillac,2,2,1,2,2,9
besito,0,1,0,1,1,3
santos,1,1,0,0,1,3
silverstatixremix,1,0,0,1,1,3
curiosity,1,1,1,1,1,5
klarar,1,1,1,1,1,5
president,2,0,1,2,1,6
royce,1,1,0,1,1,4
annies,1,0,0,0,1,2
szallegretto,0,0,0,0,1,1
maintain,1,0,1,1,0,3
goodbye,8,5,2,0,7,22
banger,0,0,0,1,0,1
belong,5,2,2,2,4,15
madrugada,1,0,0,0,1,2
deck,3,1,1,1,2,8
fifi,0,0,0,0,1,1
lontananza,0,1,0,1,0,2
helena,2,0,0,1,2,5
mckoy,0,0,0,1,0,1
mumbo,0,1,0,0,0,1
ghastly,1,0,0,0,0,1
sickman,1,0,1,0,0,2
wickedness,1,1,1,2,1,6
before,3,2,0,0,0,5
triesteitaliana,1,0,1,0,0,2
cumayon,1,1,0,1,1,4
personal,2,2,0,1,1,6
gente,1,0,1,1,1,4
better,17,7,10,9,15,58
centrali,1,1,0,1,1,4
gents,0,0,0,0,1,1
apogee,0,1,0,1,0,2
hatesex,1,0,1,1,0,3
unemployed,1,1,0,1,0,3
isea,1,0,1,1,1,4
ernesto,1,1,0,0,1,3
grammar,1,1,0,1,1,4
meat,5,5,0,2,2,14
chuckanut,1,0,1,1,0,3
acoustic,19,13,16,12,21,81
went,1,0,0,1,0,2
side,13,8,4,6,8,39
bone,1,1,0,0,1,3
mean,5,3,2,2,3,15
doux,1,1,0,1,1,4
weightless,1,1,1,1,1,5
tannenbaum,1,0,0,1,0,2
dawg,1,1,0,1,0,3
trading,1,1,1,1,1,5
jours,2,1,1,2,2,8
doug,0,1,0,0,1,2
dawn,2,1,1,1,2,7
extract,1,0,1,1,1,4
nertz,0,1,0,0,1,2
tales,3,0,2,0,3,8
gelder,1,3,0,3,0,7
lurks,1,0,1,1,1,4
tredversfurua,1,0,0,0,0,1
patricks,2,0,0,1,2,5
satana,1,0,0,1,0,2
surprise,1,0,0,0,0,1
kanssani,1,0,1,0,1,3
grease,1,2,0,2,1,6
turning,3,1,1,2,3,10
telecommunication,0,0,0,0,1,1
revenge,0,0,1,1,0,2
negocio,0,0,0,1,0,1
maurel,0,0,0,1,0,1
greasy,1,0,0,1,1,3
shaggy,1,0,0,0,1,2
loup,1,1,1,1,1,5
manisero,1,1,0,0,1,3
cosmic,1,0,0,0,0,1
undercover,0,0,0,0,1,1
mompfreed,0,0,0,0,1,1
martillo,1,1,0,1,1,4
moving,5,2,4,5,3,19
loud,1,0,1,1,2,5
yakami,0,0,0,0,1,1
fuckin,3,0,2,2,2,9
wanikaa,1,0,0,1,0,2
longue,1,0,0,1,1,3
agradea,1,1,0,1,0,3
hoop,2,0,0,0,0,2
massif,1,1,1,1,1,5
hook,1,1,1,1,1,5
disappearing,1,1,0,1,1,4
campeones,1,0,1,0,1,3
albinonis,1,1,0,0,1,3
hood,2,1,0,0,3,6
leaders,1,0,0,1,1,3
broch,1,1,0,0,0,2
bonita,0,1,0,0,0,1
girls,15,6,8,12,13,54
interlude,4,4,4,6,8,26
girle,2,0,2,2,2,8
cccp,1,1,1,1,1,5
moisture,1,0,1,1,1,4
abril,1,0,1,1,1,4
zindegi,0,0,1,1,1,3
hadnt,1,0,1,0,1,3
eastman,1,0,0,1,0,2
pluie,1,2,0,0,2,5
begins,3,1,0,1,2,7
distance,1,2,0,1,1,5
anxiety,1,0,1,0,0,2
fairytale,2,0,1,0,3,6
consuelate,1,1,0,1,1,4
preparation,1,0,0,1,1,3
matter,6,4,3,1,5,19
solomon,0,0,0,0,1,1
louder,0,0,0,3,0,3
rosario,0,0,0,1,1,2
cavaleiro,0,1,0,0,0,1
sees,1,0,1,1,1,4
modern,2,0,0,0,1,3
mind,23,9,6,16,22,76
mine,10,6,4,5,9,34
yachts,1,0,0,1,1,3
seed,3,1,1,0,2,7
commandement,1,1,0,1,1,4
tocadiscos,1,0,0,1,1,3
seen,5,1,3,2,5,16
seem,2,1,1,1,2,7
seek,2,1,1,2,1,7
tells,1,0,0,1,0,2
expeditions,1,0,0,1,0,2
andati,1,0,0,0,1,2
ablowin,1,1,0,0,0,2
timberlake,3,1,0,0,3,7
qliphothic,1,0,1,1,0,3
gabriels,1,0,0,1,1,3
llores,0,1,0,0,0,1
sleeper,2,1,1,1,1,6
siote,1,0,1,0,0,2
memorabilia,1,0,1,1,1,4
marin,1,1,1,1,0,4
regular,1,0,0,1,0,2
mharais,0,0,0,1,0,1
nietch,1,1,0,0,1,3
shabazz,1,0,1,1,1,4
marie,1,3,0,0,1,5
olhos,0,1,0,0,0,1
maria,7,5,1,2,7,22
broadcast,2,0,0,0,2,4
alarm,3,3,1,1,4,12
definitely,1,0,0,1,0,2
scotch,2,1,0,0,0,3
urgency,1,0,0,0,2,3
planetary,1,0,0,0,0,1
hunger,1,1,1,1,1,5
rapture,1,1,0,2,1,5
visitor,1,0,1,0,0,2
chord,1,1,1,1,0,4
poison,1,0,1,0,0,2
cumberland,1,0,0,1,1,3
efharisto,1,0,0,0,1,2
sugar,3,4,0,4,3,14
unleashed,1,0,0,0,1,2
quieres,1,1,0,2,2,6
gangsta,1,1,0,1,2,5
hornys,0,0,0,1,1,2
monica,0,0,0,0,1,1
hollers,1,1,0,0,1,3
vermiss,0,0,0,0,1,1
tailors,0,1,0,1,0,2
stop,22,10,11,10,14,67
coast,2,2,1,1,2,8
watermelon,2,3,1,1,3,10
breakbeat,1,0,1,1,1,4
saturn,1,0,1,0,1,3
flowerpots,0,1,0,1,0,2
fields,4,3,2,3,3,15
disco,3,1,1,3,4,12
juoksuhautatwist,1,0,0,1,0,2
softly,4,1,2,3,3,13
playstation,1,0,1,0,0,2
fascinating,0,1,0,0,0,1
cerca,1,0,0,1,1,3
reefer,2,1,2,0,1,6
preta,1,1,0,1,0,3
phull,0,0,0,1,0,1
preto,0,0,0,1,0,1
juliet,1,0,1,0,1,3
pete,1,0,1,0,0,2
voyage,1,1,1,1,0,4
said,6,1,3,4,7,21
scrap,1,1,0,1,1,4
sais,1,0,1,1,1,4
tergum,1,1,1,1,0,4
pampa,1,0,0,0,1,2
warrior,0,1,0,0,0,1
lazy,1,1,0,0,2,4
everchanging,1,0,0,0,1,2
dressin,1,0,1,0,0,2
cousin,0,1,0,0,0,1
fiacre,1,1,0,0,1,3
compton,1,1,0,1,1,4
against,4,2,2,3,3,14
nordcore,1,0,1,1,1,4
foran,0,1,0,0,0,1
fillmore,2,2,0,2,2,8
kalyan,1,1,0,1,1,4
path,1,0,0,0,0,1
iffectz,1,0,0,1,1,3
loaded,1,1,1,1,2,6
paille,1,1,0,1,1,4
putt,0,0,0,1,0,1
interesa,1,0,1,1,1,4
asky,1,0,0,0,0,1
three,14,7,5,5,10,41
alcun,1,0,0,1,0,2
lovely,3,3,1,3,3,13
riley,0,1,0,1,0,2
threw,1,0,0,0,0,1
mhet,0,1,0,0,0,1
sunshine,4,3,2,1,4,14
allez,0,1,0,1,0,2
puedes,1,0,1,1,1,4
koti,1,1,1,1,1,5
ugli,1,0,1,1,0,3
paperman,1,1,1,1,1,5
tank,0,0,0,0,1,1
servin,0,0,0,0,1,1
tang,0,0,0,0,1,1
starts,1,0,0,0,1,2
jimprovise,1,1,1,1,1,5
ugly,1,0,0,2,0,3
near,3,1,0,1,2,7
tany,1,1,0,1,1,4
balance,1,0,1,1,1,4
nows,0,1,0,0,1,2
spawn,1,0,1,0,1,3
seven,5,2,2,2,3,14
mexico,1,0,1,1,1,4
cano,0,1,0,1,0,2
ritorna,0,0,0,0,1,1
kummiset,1,1,1,1,1,5
shame,0,0,0,1,1,2
cant,37,17,16,27,23,120
deckers,1,0,1,0,0,2
amour,1,3,1,2,2,9
grown,4,3,4,2,4,17
grnn,1,0,0,0,0,1
quand,3,1,2,2,2,10
belle,0,0,0,1,0,1
make,24,13,6,17,21,81
poulenc,0,1,0,0,1,2
belly,0,1,0,1,1,3
vegetable,1,1,1,1,1,5
grows,0,0,0,0,1,1
bells,8,5,2,6,8,29
lunes,1,0,0,0,1,2
meets,1,0,0,1,0,2
livre,0,2,0,2,1,5
ella,4,3,1,2,0,10
elle,2,1,1,3,2,9
dominions,0,0,1,0,0,1
waterfall,2,2,0,1,1,6
unicorn,1,1,1,1,1,5
jealous,1,1,0,0,1,3
ruff,1,0,0,0,1,2
firedance,0,0,0,1,0,1
transamazonia,1,0,1,1,1,4
presto,1,0,0,1,1,3
lightman,1,0,0,1,0,2
unconditionally,1,1,1,0,0,3
youre,22,12,13,10,21,78
neptune,1,1,0,1,0,3
studen,0,0,0,0,1,1
practices,0,1,0,0,0,1
roma,1,1,0,1,1,4
anchorman,1,1,0,0,1,3
vargbrodern,1,0,0,1,0,2
hacen,1,0,0,0,1,2
yours,3,0,2,3,2,10
left,10,4,3,6,4,27
just,32,22,15,20,34,123
kinky,2,0,2,1,2,7
sporting,1,1,0,1,1,4
mientras,0,0,0,0,1,1
fighters,1,1,0,0,1,3
human,8,2,7,3,2,22
acappella,1,1,0,1,0,3
angelito,1,0,0,0,1,2
bananza,0,1,0,0,1,2
sunflower,0,1,0,0,1,2
savu,1,0,1,1,1,4
royal,3,2,0,2,2,9
unlearn,0,0,1,0,0,1
autumns,1,0,0,0,0,1
harald,0,0,0,0,1,1
save,3,2,2,3,4,14
atrapados,1,0,0,1,1,3
infantil,0,1,0,1,1,3
pichleh,0,0,1,1,0,2
bboy,2,2,0,2,2,8
background,5,1,1,1,4,12
performance,6,1,2,2,6,17
chorro,1,0,0,0,1,2
dreams,10,9,2,10,11,42
saginaw,1,0,1,0,0,2
shoulder,0,2,0,0,0,2
nevermind,1,0,1,0,0,2
submission,1,0,0,1,1,3
nude,1,0,0,0,0,1
leskiidin,1,0,0,1,0,2
clementina,0,0,0,0,1,1
clavelitos,1,1,0,1,1,4
desilusin,1,0,1,1,0,3
somehow,1,0,0,0,1,2
dead,11,5,7,10,4,37
hablar,0,0,0,1,0,1
dear,2,4,0,2,3,11
visitando,0,1,0,1,0,2
carta,1,1,0,1,0,3
heiliges,0,0,0,1,0,1
tartar,0,1,0,1,0,2
arbustos,0,1,0,1,0,2
burn,5,1,0,3,2,11
boll,1,2,0,0,0,3
lolaila,0,0,0,1,0,1
protagonist,1,0,0,0,0,1
wrapup,0,1,0,1,1,3
blackest,1,0,0,0,0,1
bury,4,0,1,2,1,8
hardfloor,1,0,1,1,1,4
spanns,1,1,0,0,0,2
pugie,1,0,0,0,1,2
keros,1,0,0,0,1,2
motownphilly,0,0,0,0,1,1
valentines,1,1,0,1,1,4
beta,1,1,0,0,1,3
afternoon,2,1,1,2,1,7
luan,0,0,0,0,1,1
thelo,0,0,0,0,1,1
coins,1,0,0,0,0,1
whats,9,3,5,4,7,28
lied,2,1,0,3,2,8
castanets,1,0,0,1,1,3
down,58,29,23,24,45,179
lies,9,3,4,6,7,29
whatd,1,0,1,0,1,3
suba,0,1,0,0,0,1
chime,1,1,1,2,1,6
birdies,1,1,0,0,1,3
parade,3,3,2,2,2,12
flying,1,2,1,1,2,7
leaf,0,1,0,0,0,1
fathers,2,1,1,1,2,7
aglatma,0,1,0,0,1,2
starve,1,0,1,1,0,3
redman,0,0,0,0,1,1
fora,0,0,0,0,1,1
zeigt,1,0,1,0,1,3
failure,1,0,1,0,0,2
forr,0,1,0,1,0,2
surrender,2,2,1,1,2,8
fort,1,0,0,0,1,2
aruanda,0,1,0,0,0,1
jouer,1,1,0,1,1,4
untitled,3,1,2,2,1,9
whiskey,1,1,0,0,1,3
captin,0,1,0,0,0,1
sapphire,1,1,0,1,1,4
boomerang,2,0,2,1,0,5
daddy,3,2,1,2,3,11
underarms,1,1,0,1,1,4
zeno,1,0,1,1,1,4
classic,1,0,1,0,0,2
petit,2,1,1,2,3,9
pathaans,0,0,0,1,0,1
tarnished,1,0,1,1,1,4
fashioned,2,1,0,0,1,4
awhile,1,1,0,1,1,4
widows,1,0,1,1,0,3
unholy,1,0,1,0,0,2
shit,3,1,0,3,2,9
holla,0,0,0,1,0,1
handel,4,0,0,4,4,12
zhong,1,0,0,1,3,5
handed,0,1,0,1,0,2
digital,93,68,39,63,95,358
snowdrops,1,0,1,0,1,3
holly,1,1,0,0,1,3
fuschnick,1,1,1,1,0,4
tamale,1,1,1,1,1,5
dies,2,1,1,0,2,6
provisoirement,1,0,0,0,0,1
dieu,1,1,0,1,1,4
nykii,1,0,0,0,0,1
fell,2,0,1,0,2,5
lafayettes,0,0,3,0,3,6
geroi,0,0,0,1,1,2
barracuda,1,0,0,0,1,2
died,1,0,0,0,1,2
jones,4,2,1,1,3,11
noviembre,0,0,0,1,0,1
outskirts,2,1,1,1,1,6
clubmix,1,1,0,1,1,4
shaskeen,1,0,0,0,0,1
teeth,2,1,2,1,0,6
poussire,1,0,1,1,1,4
proletariat,1,1,1,1,0,4
exspecto,0,0,0,1,0,1
skit,3,6,1,3,4,17
telefon,1,1,1,1,1,5
menoo,1,1,1,1,1,5
soulo,0,0,0,0,1,1
mile,3,1,2,0,1,7
skin,5,1,1,1,4,12
mill,2,1,1,1,0,5
milk,1,1,0,0,1,3
suicide,2,0,1,1,1,5
praises,0,1,0,0,0,1
gheera,0,0,1,1,1,3
verrckt,1,0,0,1,1,3
torna,1,1,1,0,1,4
father,5,3,2,2,1,13
hurtin,1,0,0,0,1,2
lotus,1,1,1,1,1,5
finally,3,2,2,1,3,11
string,2,3,0,3,1,9
jezebel,1,0,1,1,1,4
lynch,1,1,0,1,0,3
anne,2,0,1,0,1,4
jhatt,0,0,0,1,0,1
somos,1,0,0,1,1,3
prvni,1,1,1,0,1,4
round,12,9,1,9,9,40
nomadbrothers,0,1,0,0,1,2
work,3,3,0,4,3,13
shava,0,0,0,1,0,1
camelot,1,1,0,1,0,3
etiinen,1,0,0,0,1,2
rafaniello,0,0,1,1,0,2
fistful,1,0,0,1,0,2
heres,0,0,0,1,1,2
filles,1,0,0,1,1,3
kommissar,1,1,1,1,1,5
guardian,2,2,1,2,2,9
ridin,1,1,0,1,1,4
french,3,3,2,4,4,16
jazze,1,0,0,0,1,2
kpenhaminassa,1,1,0,0,1,3
wait,8,6,4,4,8,30
zombie,1,0,1,1,1,4
spencertracey,1,1,1,0,1,4
shift,0,0,0,1,0,1
mortii,1,0,0,1,0,2
monades,1,1,0,1,1,4
teenage,3,1,0,1,0,5
consolation,2,0,0,0,1,3
roter,1,1,0,1,1,4
everybody,4,2,2,3,3,14
kopla,1,1,1,1,1,5
layne,2,1,0,0,0,3
sake,3,0,1,1,1,6
dude,1,1,0,1,0,3
javais,1,1,0,0,1,3
france,5,2,1,3,4,15
terrarium,0,0,0,1,0,1
thru,1,0,0,0,1,2
vous,3,2,0,1,2,8
velem,1,0,0,1,1,3
freestyle,2,1,1,2,1,7
novio,0,0,0,0,2,2
americano,1,0,0,0,0,1
downtown,3,2,2,1,3,11
ferrous,0,0,0,1,1,2
olive,1,0,1,1,1,4
pollys,1,1,0,1,1,4
baltechs,1,1,0,0,0,2
labrie,1,1,0,1,0,3
abbeville,1,0,0,0,0,1
spoonie,0,1,0,1,1,3
bongsession,1,0,1,0,0,2
soul,24,18,8,13,12,75
sous,2,3,0,1,4,10
sour,1,1,0,1,0,3
sitiera,0,0,0,0,1,1
djungelstadt,0,0,0,1,0,1
making,0,0,0,1,0,1
hiroshima,2,0,0,2,0,4
merzwaltz,1,0,1,1,0,3
crazy,10,8,5,3,11,37
funhouse,1,0,1,0,0,2
fuck,1,0,0,1,2,4
manuels,1,1,0,1,1,4
sample,6,5,1,5,6,23
psihi,0,0,0,0,1,1
acapulco,1,1,0,0,1,3
craze,1,1,1,1,0,4
pink,1,0,1,1,0,3
oslo,1,0,0,0,0,1
ping,1,0,0,0,1,2
pind,0,0,0,0,1,1
till,4,2,3,5,5,19
sunday,8,3,6,5,6,28
radioalbum,1,1,0,1,1,4
pure,2,1,2,2,1,8
maestro,2,1,2,2,2,9
persuasion,1,1,0,0,1,3
puro,0,1,0,0,1,2
loaves,1,1,0,0,1,3
designer,1,0,1,1,0,3
huitquarts,0,0,0,1,0,1
punjabian,1,1,1,1,1,5
hombre,1,0,0,0,1,2
guys,4,1,2,1,4,12
grow,5,3,0,3,4,15
neck,3,1,0,2,1,7
johnson,0,0,0,1,1,2
maybe,3,3,1,1,2,10
punnany,1,0,0,0,0,1
cantabile,1,1,0,1,0,3
jail,2,1,0,0,1,4
slangen,1,0,1,0,0,2
african,0,1,0,0,0,1
thorns,1,0,1,0,0,2
tall,1,0,0,0,0,1
talk,16,8,8,11,13,56
bozack,0,0,0,1,0,1
gatemouth,1,1,0,0,1,3
shoes,2,1,2,1,2,8
josephine,2,2,2,2,2,10
immer,1,1,1,1,0,4
getunow,1,1,0,1,1,4
shake,6,4,2,6,6,24
irene,1,0,0,0,0,1
texan,1,1,0,0,0,2
police,2,1,0,0,1,4
thank,7,3,4,4,4,22
mais,1,1,1,1,1,5
thang,3,2,2,4,3,14
buckys,1,1,0,1,1,4
akhan,0,0,0,0,1,1
ours,1,1,0,0,1,3
main,6,4,3,5,6,24
texas,2,1,0,1,0,4
within,3,0,2,0,0,5
killer,5,2,1,2,3,13
minuet,2,1,0,2,2,7
mortuorum,0,0,0,1,0,1
safari,1,1,0,1,1,4
sisyphe,0,0,1,1,0,2
killed,5,3,3,3,4,18
teller,1,0,0,0,1,2
buntar,1,0,0,1,0,2
feverish,1,1,1,1,1,5
arrows,1,1,0,1,0,3
careless,2,2,0,1,2,7
rock,39,14,18,19,31,121
hammerklavier,1,0,0,1,1,3
bombo,0,0,0,0,1,1
vogue,1,0,0,0,1,2
odysseymovement,1,0,0,1,1,3
abnormal,1,1,1,0,1,4
vagabond,1,2,0,1,1,5
manifesto,1,0,1,0,1,3
preaching,1,1,0,1,1,4
giro,2,2,2,2,2,10
girl,42,17,26,29,40,154
morning,18,12,4,8,16,58
canada,2,1,0,2,1,6
living,5,2,3,3,4,17
eyolf,1,0,0,0,0,1
plaisir,1,0,1,1,1,4
jackson,0,0,0,0,1,1
multiplayer,0,0,0,1,0,1
resilience,1,0,0,1,1,3
firewater,1,0,1,0,0,2
miles,4,2,3,1,4,14
nudez,0,0,0,0,1,1
haydn,0,1,0,0,1,2
assurance,1,0,0,0,1,2
monster,1,1,0,1,1,4
bodhrn,1,0,0,0,0,1
california,3,1,2,1,2,9
amigos,2,0,1,0,2,5
awayhere,1,1,1,1,1,5
watts,1,0,0,1,1,3
sabor,1,3,1,2,1,8
carnival,1,3,0,1,2,7
ministry,1,1,0,1,0,3
worrying,1,0,0,0,1,2
thing,13,11,6,10,14,54
funky,3,2,3,4,2,14
thine,3,1,0,2,3,9
desultory,1,0,0,1,1,3
think,13,7,3,6,14,43
first,15,6,6,13,15,55
journeyiv,1,1,0,0,1,3
lascia,1,0,0,0,1,2
americana,2,0,1,1,2,6
nicpig,0,0,0,1,0,1
lone,1,1,0,1,1,4
mlodie,1,1,0,0,1,3
fast,2,3,0,1,1,7
carry,1,1,1,1,1,5
sounds,3,3,2,4,2,14
little,48,32,16,26,40,162
chanson,1,1,0,1,6,9
slept,0,1,0,0,0,1
laquelle,1,1,0,1,1,4
anyone,1,1,0,1,1,4
plains,1,0,0,0,1,2
fiery,1,0,0,1,0,2
jeannette,0,1,0,0,1,2
bruk,0,0,0,0,1,1
cetait,1,1,0,1,1,4
mermaid,1,0,1,0,0,2
bloodshed,1,0,0,0,0,1
eyes,22,11,13,15,17,78
moscow,1,0,0,0,0,1
marrakech,1,0,0,1,1,3
buts,1,1,0,1,0,3
harbour,0,1,0,0,0,1
eyed,1,1,0,0,2,4
butt,1,1,1,1,1,5
embraceable,1,1,0,1,1,4
cracks,1,0,1,0,0,2
sailing,1,0,2,1,1,5
gotta,11,2,6,8,8,35
cabiria,1,1,0,0,0,2
lappart,1,1,1,1,1,5
marcharte,0,0,0,1,1,2
loiseau,0,1,0,0,0,1
were,15,9,6,7,12,49
burbs,1,0,1,1,0,3
cuir,1,0,1,1,1,4
lullaby,10,6,5,5,8,34
marijuana,1,0,1,0,1,3
voices,5,4,1,3,4,17
dash,0,0,0,1,0,1
winding,1,0,1,1,1,4
lamb,3,0,0,0,1,4
kevin,1,0,1,0,0,2
isolate,1,0,1,0,0,2
brillantes,1,1,1,1,1,5
squad,2,1,1,1,2,7
bailey,1,1,1,1,0,4
valse,5,6,0,2,6,19
ultimate,0,1,0,1,1,3
blackfoot,1,0,1,1,1,4
skinned,0,1,0,0,0,1
pain,6,3,1,3,5,18
theatre,3,2,0,3,2,10
track,31,12,10,19,21,93
zigzag,1,1,0,1,1,4
insanity,0,0,1,1,0,2
rehearsal,1,1,0,0,1,3
paix,1,1,1,0,1,4
barrage,0,1,1,0,0,2
skinner,0,1,0,1,0,2
nadine,1,0,1,0,0,2
pair,1,1,0,0,0,2
tracy,2,1,0,1,1,5
queens,0,0,0,0,1,1
pequeo,1,1,0,1,0,3
surprising,1,0,0,0,0,1
lenny,1,0,1,1,0,3
gracefully,1,0,0,0,0,1
fille,1,1,1,1,1,5
voodoo,3,1,0,0,1,5
nlida,0,1,0,1,0,2
shop,1,0,1,1,1,4
shot,2,1,1,1,3,8
shou,1,0,0,0,3,4
show,14,6,7,8,10,45
olvidar,0,0,0,0,1,1
estoy,1,0,0,1,2,4
corney,1,1,0,0,0,2
campana,0,1,0,0,0,1
corner,4,5,2,1,5,17
campane,1,1,0,0,1,3
lieder,1,1,1,1,1,5
stormy,1,1,0,0,1,3
dich,2,0,1,2,3,8
behind,0,0,0,1,0,1
black,16,10,4,12,9,51
ranking,1,0,0,1,1,3
poquitito,0,0,0,0,1,1
munk,1,1,1,1,1,5
otthat,0,0,0,0,1,1
stomp,1,1,1,1,1,5
hippa,1,0,0,1,0,2
irapijerkifly,0,0,0,0,1,1
vitrier,1,1,0,0,1,3
nouveau,0,0,0,1,0,1
trumansburg,1,1,0,1,1,4
probka,1,1,0,0,1,3
spter,1,1,0,1,1,4
medias,1,0,0,0,1,2
stupid,1,0,1,0,0,2
mergences,1,1,0,0,0,2
flamingos,0,1,0,1,0,2
bachata,1,0,0,1,1,3
sittin,2,2,0,0,1,5
boleyn,1,0,0,0,0,1
oven,1,1,1,1,1,5
float,1,0,0,0,1,2
sean,2,2,1,3,1,9
revois,1,1,0,0,1,3
wonder,3,2,1,1,4,11
arbre,1,1,0,0,1,3
twosided,1,1,1,1,0,4
distantes,2,2,0,2,2,8
apisti,1,0,0,0,1,2
vanne,0,0,0,1,0,1
enough,8,1,2,2,6,19
diamonds,1,2,0,1,1,5
across,2,1,1,1,1,6
timmy,1,2,0,2,0,5
killing,5,1,1,4,3,14
muchachas,0,1,0,0,0,1
chacha,0,0,0,1,1,2
nougaro,1,1,1,1,1,5
nocturne,1,1,0,0,1,3
according,0,0,0,1,0,1
nonpa,1,0,0,0,0,1
baile,1,0,0,0,1,2
tour,6,3,1,5,5,20
tous,2,1,0,2,2,7
tout,1,1,0,0,1,3
guardians,1,0,1,0,0,2
among,0,1,0,2,1,4
miattad,1,0,1,1,1,4
scherzo,1,0,0,1,1,3
garota,1,1,0,0,1,3
sailin,1,1,0,0,0,2
kathleens,1,1,0,1,0,3
hanuriin,1,0,0,1,1,3
sensible,0,0,0,0,1,1
unusual,1,1,0,1,1,4
tercer,1,0,0,0,1,2
underworld,1,0,0,1,0,2
tramp,1,1,0,0,1,3
djessy,0,1,0,1,1,3
mari,2,1,0,1,2,6
mark,3,2,1,2,2,10
arte,1,0,0,1,1,3
mars,3,0,0,2,2,7
mary,11,3,2,2,6,24
pathfinders,1,0,0,1,0,2
graveyard,1,0,1,1,1,4
festante,1,0,0,0,1,2
puerile,1,0,1,1,1,4
wake,10,1,8,4,8,31
declaration,1,0,0,0,0,1
overdose,1,0,0,0,0,1
hardcore,0,0,0,1,0,1
ascolta,1,0,0,0,1,2
those,5,3,2,2,4,16
wyomin,1,0,0,1,0,2
sound,12,4,7,9,10,42
disconnected,1,1,1,1,1,5
saboreando,0,0,0,1,0,1
ongoing,1,0,1,0,0,2
coco,2,0,0,2,2,6
cock,1,0,0,0,0,1
coffee,0,1,0,0,0,1
marcel,1,0,1,1,1,4
sleeping,4,1,3,3,3,14
strain,1,1,0,1,0,3
dangerously,1,1,0,0,1,3
cariocas,1,1,0,0,1,3
pamella,1,1,1,1,1,5
everyday,5,3,3,3,4,18
bags,0,0,0,2,2,4
different,2,3,0,1,1,7
harsh,1,0,1,1,0,3
doctor,3,2,2,2,2,11
rappst,1,0,0,1,1,3
same,12,10,7,9,13,51
waterliked,0,0,0,0,1,1
heartbreak,1,0,1,1,1,4
speech,1,1,0,1,1,4
elementro,0,0,0,1,0,1
extended,10,7,6,11,11,45
pega,1,1,0,0,1,3
running,5,2,2,2,6,17
improv,0,1,0,1,1,3
nostradamus,0,0,0,0,1,1
totally,1,0,1,0,1,3
nevadas,1,0,0,0,1,2
markus,1,1,1,1,1,5
maracaibo,0,1,0,0,1,2
spoonful,1,1,0,1,0,3
ryman,1,0,0,0,1,2
bottle,2,1,1,1,1,6
money,9,4,4,5,6,28
nordfjorloftet,1,0,0,1,0,2
voiliers,1,1,1,1,1,5
flavor,0,0,0,0,1,1
alimony,0,0,0,0,1,1
bowie,1,0,0,1,1,3
pila,0,0,1,0,1,2
tren,0,0,0,1,1,2
pile,1,1,0,0,2,4
lahnstein,1,0,0,0,0,1
meteorito,0,0,0,0,1,1
gris,2,0,0,2,2,6
docks,1,1,0,1,0,3
ricerca,1,1,0,1,1,4
dodos,0,1,0,0,0,1
forge,1,0,0,0,0,1
grid,1,0,1,0,0,2
railroad,1,0,1,1,0,3
implicate,1,1,0,1,1,4
grim,3,0,3,3,0,9
grin,1,0,0,0,0,1
fondling,1,0,0,1,1,3
perdus,1,1,0,0,1,3
christina,3,2,1,0,1,7
server,1,1,0,1,0,3
chamber,2,0,0,2,0,4
thighs,1,1,1,0,1,4
hallelujah,1,0,1,1,1,4
served,1,0,1,0,0,2
remasteris,1,2,1,2,1,7
robbers,1,0,0,1,0,2
baixinho,0,1,0,0,0,1
kpenhamn,1,1,0,0,1,3
doll,4,4,2,3,4,17
naal,0,0,0,1,0,1
felguk,1,0,0,0,1,2
cadenaslive,0,0,0,0,1,1
spasa,0,0,0,0,1,1
choir,1,1,1,0,0,3
bones,3,1,1,1,3,9
ellis,0,1,0,1,0,2
qiang,0,0,0,0,1,1
moderato,1,0,1,1,0,3
oute,1,0,0,0,1,2
linoleum,1,0,0,0,1,2
knife,2,1,0,0,1,4
brigid,0,0,0,0,1,1
seconds,1,0,1,0,1,3
jennings,1,1,0,0,1,3
arts,1,1,0,0,1,3
broken,8,3,4,4,5,24
secondo,0,0,0,0,1,1
descontrol,0,0,0,0,1,1
drums,1,1,1,1,1,5
unissued,1,0,1,0,1,3
soorma,0,0,0,1,0,1
island,1,1,0,2,1,5
violence,1,1,0,1,0,3
doiseau,1,1,0,0,1,3
youve,3,2,1,2,2,10
mixed,1,1,0,0,1,3
road,12,5,6,7,11,41
honky,1,1,0,1,1,4
lands,1,1,0,1,1,4
fertile,1,0,1,0,1,3
whites,1,0,0,1,0,2
whiter,2,1,0,2,2,7
seora,0,1,0,0,0,1
crossfire,2,0,1,1,1,5
empress,0,0,0,1,0,1
fresse,0,0,0,1,0,1
strip,1,0,0,1,1,3
prendsmoi,0,0,1,0,0,1
versin,1,1,0,0,1,3
jerusalem,1,1,0,0,1,3
wildfire,1,1,0,0,0,2
brute,1,0,0,0,0,1
fates,1,0,1,0,1,3
lions,1,0,1,0,1,3
trey,0,0,0,0,1,1
emeralds,1,1,0,1,1,4
delilah,1,1,0,0,1,3
pulmn,1,0,1,0,1,3
risin,1,0,1,0,0,2
strikes,3,1,1,1,1,7
sophisticated,0,1,0,1,0,2
laina,0,0,0,1,0,1
gora,0,0,0,2,2,4
mayerling,1,1,0,1,1,4
romantic,3,0,0,1,0,4
elmss,1,0,1,1,1,4
benton,1,0,1,1,0,3
miyela,1,1,0,1,1,4
hispaniola,0,1,0,0,0,1
meng,0,0,0,0,1,1
manuel,1,1,0,0,0,2
conqueror,1,0,1,1,0,3
sandpolskan,0,0,0,1,0,1
affection,0,1,0,0,1,2
piroschka,1,0,0,1,1,3
celestial,1,0,1,1,1,4
carpe,1,0,1,1,0,3
groovin,3,2,0,2,2,9
deep,12,4,5,5,14,40
fellow,1,1,0,1,0,3
imagination,1,1,0,2,2,6
gumby,1,1,1,1,1,5
outtake,2,2,1,2,2,9
hound,2,2,0,1,1,6
film,1,1,0,0,0,2
again,36,14,14,17,29,110
pottajenkka,1,1,1,1,1,5
suitehearts,1,0,1,0,1,3
field,1,0,1,0,0,2
astronaut,1,1,0,1,0,3
moizamicy,1,0,0,0,0,1
acoustique,1,0,1,1,1,4
shelter,1,2,1,2,1,7
larock,0,0,0,1,0,1
abscondence,0,0,0,0,1,1
corcovado,1,2,1,1,2,7
keepin,0,0,0,1,0,1
chris,1,0,2,2,0,5
diabla,1,0,0,0,1,2
remaster,90,68,38,62,92,350
diable,1,1,1,0,1,4
remote,1,0,1,0,1,3
jlai,1,0,0,0,0,1
gigantor,1,0,1,0,1,3
alright,10,4,8,4,9,35
nunca,0,0,0,1,1,2
represent,1,0,0,0,0,1
liar,2,0,0,1,0,3
forget,4,3,1,3,4,15
forbidden,1,0,1,1,1,4
tappartiens,0,1,0,0,1,2
yhteinen,1,1,1,1,1,5
wexford,1,0,0,0,0,1
talks,1,0,1,1,1,4
liao,0,0,0,0,1,1
children,4,1,3,2,4,14
shattered,2,1,2,1,1,7
anglais,1,1,0,0,1,3
imma,1,0,0,0,1,2
alberts,1,1,0,1,1,4
enkeli,1,0,0,0,0,1
estrofas,1,0,0,0,0,1
crimson,2,1,0,1,1,5
mornin,1,1,0,2,2,6
sitting,2,1,0,0,1,4
billie,1,1,0,1,1,4
einmal,2,0,1,1,2,6
fall,10,4,4,5,9,32
subterranean,1,1,1,1,1,5
difference,3,1,0,1,2,7
bestio,1,1,1,1,0,4
alcazar,0,1,0,1,0,2
lumier,0,0,0,1,0,1
hollerin,1,0,0,0,0,1
alma,4,2,0,3,4,13
mothers,3,1,4,2,3,13
beeatch,0,0,0,1,0,1
gang,0,0,0,0,1,1
explorador,1,0,0,0,1,2
zero,3,2,1,3,3,12
titles,2,1,0,0,1,4
lawyer,1,1,0,0,0,2
incide,1,0,0,0,0,1
creatures,1,0,0,0,1,2
timxtreme,1,0,1,1,1,4
stood,3,3,1,2,3,12
dcor,1,1,1,1,1,5
tribute,2,1,1,2,1,7
everlasting,1,1,1,0,1,4
dias,0,0,0,1,0,1
movement,5,0,1,3,3,12
christe,1,0,1,1,1,4
mule,2,2,1,1,1,7
ranger,1,0,0,1,0,2
beacon,2,2,0,2,2,8
simon,2,1,2,1,2,8
vals,1,1,1,1,2,6
qutate,1,0,0,0,1,2
sabras,0,0,0,1,1,2
search,2,2,1,2,2,9
jackie,1,1,0,0,0,2
noites,2,2,0,0,2,6
paid,1,0,0,0,1,2
conts,1,0,1,0,1,3
misery,1,1,0,0,0,2
felicidade,1,1,0,1,0,3
dansende,0,1,0,0,0,1
minutos,1,0,0,1,0,2
slaughtergod,1,0,1,0,0,2
caravan,0,0,1,0,0,1
mastering,0,1,0,1,0,2
africa,1,0,0,0,1,2
emptied,0,1,0,1,1,3
suits,1,1,0,1,0,3
nothings,2,2,2,2,2,10
astrodome,0,0,0,0,1,1
destination,1,0,1,1,1,4
laivamatka,1,1,0,1,1,4
apertura,1,1,0,1,1,4
neverending,2,1,1,2,1,7
chiamano,0,0,0,0,1,1
diamond,4,1,3,2,4,14
asheville,1,0,0,0,0,1
lemons,1,0,1,0,0,2
caderona,0,1,0,0,0,1
komm,1,1,0,1,1,4
karaoke,0,0,0,1,1,2
town,22,13,9,13,17,74
guarda,1,1,0,1,1,4
plaintes,1,0,0,1,1,3
hour,4,2,1,4,2,13
voyagers,0,1,0,1,0,2
bascombe,1,0,0,1,1,3
fefita,1,1,0,1,1,4
nupcial,1,0,1,0,1,3
numbers,2,1,1,1,1,6
glorieux,0,2,0,3,0,5
robinson,1,1,0,0,0,2
mackab,1,0,0,1,1,3
needs,1,1,1,1,0,4
needy,0,1,0,0,0,1
comfort,1,0,1,0,1,3
tysikasvuinen,1,0,0,0,1,2
mditations,0,1,0,1,0,2
sacred,1,0,0,0,0,1
ensemble,0,1,0,0,1,2
rastafari,1,1,0,1,1,4
viene,1,0,1,1,1,4
petite,2,2,2,2,1,9
advice,2,0,1,1,2,6
viens,0,1,0,1,2,4
petits,2,2,1,2,2,9
blood,16,4,5,8,8,41
coming,7,4,2,5,4,22
kaufen,1,1,0,1,1,4
trois,2,0,1,2,2,7
orchard,1,1,0,1,1,4
dragon,2,0,0,1,0,3
coal,1,1,0,0,0,2
turnpike,1,0,0,0,0,1
pleasure,1,1,1,2,1,6
playing,3,2,0,1,2,8
serenade,3,3,1,2,3,12
infant,1,1,0,1,1,4
shubas,1,1,1,0,1,4
radar,1,0,0,0,1,2
through,11,9,4,10,11,45
suffer,1,0,0,0,0,1
winger,1,0,1,1,1,4
balon,1,0,0,1,1,3
baat,1,1,1,1,1,5
late,3,0,5,2,2,12
pena,1,1,0,1,2,5
vajda,0,0,0,1,1,2
ravnec,1,1,0,0,1,3
remmus,1,1,1,0,1,4
ralphs,1,1,0,1,0,3
excepcion,1,0,1,1,1,4
hecha,1,0,0,0,1,2
walls,4,2,2,4,4,16
ralphi,0,0,0,1,1,2
goor,1,1,1,1,1,5
complain,1,1,0,1,1,4
mystery,1,0,1,1,1,4
compter,1,1,1,1,1,5
rant,1,0,0,1,1,3
empiece,1,0,1,1,1,4
malone,1,1,0,1,0,3
ashes,2,0,1,1,1,5
someone,6,3,2,3,7,21
learing,1,0,0,0,1,2
mbta,1,0,0,0,1,2
pulecenella,0,0,0,0,1,1
monsoon,1,0,0,0,1,2
harboring,1,0,0,0,0,1
towin,1,1,1,0,0,3
everyone,3,0,1,1,1,6
chopper,1,0,0,1,1,3
house,23,11,13,10,22,79
fish,1,0,1,1,0,3
hard,12,7,6,7,6,38
connect,1,1,0,1,1,4
portland,1,1,1,1,1,5
insurance,1,1,0,1,1,4
mystre,0,1,0,1,0,2
lovers,5,5,1,2,5,18
perro,1,0,1,1,1,4
print,2,2,2,2,2,10
pehle,0,0,0,1,0,1
bully,2,0,2,0,2,6
caravane,1,0,1,1,1,4
cielito,0,0,0,0,1,1
disposition,2,0,1,2,1,6
beginning,4,2,2,2,3,13
bendiga,0,1,0,1,1,3
finland,1,1,0,1,1,4
wither,0,0,1,0,1,2
rainforest,1,1,0,1,1,4
dont,97,51,37,53,83,321
nach,0,0,0,2,0,2
valentine,0,1,0,0,0,1
entanglement,1,1,1,1,0,4
done,5,4,1,2,4,16
cade,1,0,0,1,0,2
pudor,1,0,0,0,1,2
razor,1,0,1,0,1,3
least,1,0,0,0,1,2
mami,0,1,0,0,0,1
paint,1,1,1,1,1,5
larrach,1,0,0,0,0,1
jetta,1,0,1,1,1,4
mama,6,4,1,3,2,16
ordure,1,1,1,1,1,5
para,4,2,1,3,5,15
etsi,1,0,0,1,1,3
park,3,1,1,2,2,9
sensation,1,0,1,0,1,3
part,26,13,16,21,20,96
lhomme,1,1,0,1,2,5
believe,11,6,4,6,12,39
supplice,1,0,0,1,1,3
mclaughlin,0,1,0,1,1,3
youth,4,1,1,3,3,12
vierge,0,1,0,1,0,2
ubik,1,0,1,1,1,4
liberabo,0,0,0,0,1,1
outta,2,1,2,0,2,7
highspeed,1,0,0,1,1,3
fading,1,0,0,0,1,2
backseat,1,1,0,0,0,2
mountain,5,1,0,3,4,13
madazulu,1,1,0,1,1,4
dancing,9,2,6,5,8,30
flaming,1,0,0,0,1,2
build,1,1,0,0,1,3
mose,0,0,0,1,1,2
serene,0,1,0,0,0,1
serena,1,0,0,0,0,1
flute,2,3,1,2,2,10
essa,0,1,0,0,0,1
moss,1,1,1,1,1,5
gyere,1,0,0,1,1,3
reflections,1,1,0,1,1,4
tellurique,1,0,0,1,0,2
sector,1,1,1,1,1,5
thomas,1,1,0,1,1,4
guantanamera,1,1,0,0,1,3
sparrow,2,1,2,1,2,8
wailing,1,1,1,1,0,4
posterchild,1,0,1,1,1,4
carne,2,1,0,1,1,5
fina,1,1,0,1,1,4
headlines,1,0,0,0,1,2
auditorio,1,0,0,0,1,2
fine,4,3,3,4,4,18
find,8,7,0,8,7,30
negura,1,0,0,1,0,2
frisch,1,1,1,1,1,5
chimes,0,0,0,1,1,2
giant,0,1,0,1,1,3
tocame,0,0,0,0,1,1
legionnaire,1,1,0,0,1,3
nervous,2,0,2,2,2,8
poppin,1,0,0,0,1,2
matesi,1,0,0,1,1,3
unhappy,1,0,0,0,0,1
eleison,1,0,1,1,1,4
weve,3,3,1,3,3,13
mein,3,2,0,2,4,11
rest,2,3,1,3,2,11
suzie,1,0,0,1,1,3
contagious,2,0,1,2,0,5
lachen,1,1,0,1,1,4
common,1,2,1,2,2,8
gospel,2,0,0,1,2,5
severing,1,0,0,1,1,3
sessionsaol,1,0,1,0,1,3
devils,4,4,2,4,3,17
vine,1,1,0,2,1,5
devilz,1,0,0,0,0,1
tender,1,1,0,0,0,2
fruta,0,1,0,1,0,2
fang,1,0,0,2,2,5
pennoe,1,0,0,1,0,2
please,16,7,7,7,12,49
riccardoamelia,1,0,0,1,0,2
powerhouse,1,0,0,0,1,2
fans,1,0,1,1,1,4
burned,1,0,0,0,0,1
champagne,3,1,1,1,2,8
rosie,1,1,0,0,1,3
gulabi,0,0,0,1,0,1
nashville,1,0,1,1,1,4
mailbox,1,0,0,0,1,2
fuckaz,0,0,0,1,0,1
pepsi,0,1,0,1,0,2
marilyn,1,0,1,1,1,4
gnosis,0,0,0,1,0,1
restaurant,1,1,0,0,1,3
magdalaine,1,0,1,1,1,4
foreign,1,0,0,0,0,1
afar,1,0,0,0,1,2
baltimore,1,0,0,0,1,2
cakes,1,1,0,0,1,3
consume,1,0,1,0,0,2
point,1,0,1,0,1,3
simple,7,2,1,4,5,19
keypremiere,1,1,0,1,1,4
andar,1,0,0,0,1,2
gypsy,1,2,0,0,2,5
dances,2,1,1,0,1,5
dancer,3,3,0,3,2,11
poing,1,0,1,1,1,4
nakon,1,0,0,0,0,1
ertegun,1,1,0,0,1,3
expensive,1,0,1,1,1,4
elektro,1,0,0,1,1,3
raise,2,1,0,0,1,4
glocks,0,0,0,0,1,1
create,1,0,0,0,1,2
secret,7,3,3,5,6,24
ireland,0,1,0,0,0,1
sudenkorento,1,0,0,1,1,3
meeting,1,0,0,1,1,3
slips,2,0,1,0,1,4
addison,1,0,1,1,1,4
understand,3,1,1,1,3,9
pueblito,1,1,0,1,1,4
ignis,1,0,1,1,0,3
solid,1,0,1,1,1,4
bill,2,1,2,2,1,8
eclipsed,1,0,0,0,1,2
billies,1,1,1,0,1,4
skiff,1,1,0,1,0,3
deckard,1,0,1,1,0,3
escapin,0,1,0,1,0,2
portugal,0,0,0,1,0,1
century,3,0,4,1,1,9
wollen,1,0,1,1,1,4
jake,1,0,0,1,1,3
trafiko,0,0,0,1,0,1
xtra,0,0,0,1,0,1
recht,1,0,0,0,0,1
remedio,1,1,0,1,1,4
selfportrait,0,1,0,0,0,1
janus,1,0,0,0,1,2
butcher,1,1,0,0,0,2
comprimise,1,1,1,1,1,5
basta,0,1,0,0,1,2
achek,0,0,1,1,1,3
strips,1,0,1,0,0,2
keys,2,1,0,2,1,6
yesterday,0,0,0,1,0,1
husbands,1,1,1,1,1,5
moment,6,4,3,2,3,18
tash,1,0,0,2,1,4
camron,0,0,0,1,0,1
finesse,0,1,0,0,1,2
entre,3,0,1,2,3,9
werewolf,1,0,0,1,1,3
spent,1,0,1,0,0,2
phillippe,1,0,0,1,1,3
sajana,0,1,0,1,0,2
chemistry,1,0,1,0,0,2
spend,2,1,1,1,2,7
nols,1,0,0,1,1,3
liverpoolin,1,1,1,1,1,5
guang,0,0,0,0,2,2
shape,1,0,0,0,1,2
atomic,1,0,1,1,1,4
cancin,2,2,1,2,2,9
terslintu,0,0,0,0,1,1
alternative,1,0,0,0,1,2
pranafestation,0,0,0,1,0,1
nuestro,1,0,0,0,1,2
letting,2,0,1,0,0,3
hated,2,1,0,1,0,4
alternate,2,2,2,1,4,11
calibre,0,1,0,1,1,3
easter,0,2,0,0,0,2
laughed,1,0,0,0,0,1
judgement,2,0,1,1,1,5
matters,1,0,1,1,1,4
vapour,0,0,0,1,0,1
knock,2,1,0,0,0,3
calypso,1,0,0,1,1,3
feriado,1,0,0,0,1,2
shudder,1,0,1,1,1,4
bamboo,1,1,0,1,0,3
foolish,1,1,0,2,2,6
limportant,1,1,0,1,1,4
vergeht,1,1,1,1,1,5
collectors,1,1,0,0,0,2
triceratops,1,1,0,1,0,3
magnificent,1,0,1,1,1,4
barracos,0,1,0,1,0,2
bach,2,1,1,0,1,5
baci,1,0,0,0,1,2
strongest,1,1,1,1,1,5
cicada,1,0,1,0,1,3
mirror,3,0,2,1,1,7
lightning,2,0,1,2,1,6
rockdrive,1,0,1,1,1,4
jewelry,1,1,1,1,1,5
energia,0,1,0,1,0,2
hoochie,1,1,1,1,1,5
lark,1,0,1,1,1,4
acte,1,0,0,0,1,2
larh,0,0,0,1,0,1
laughing,1,1,1,0,0,3
sangha,2,2,0,2,2,8
bewitched,1,0,0,0,1,2
kudian,0,0,0,0,2,2
birdsongs,1,1,0,1,0,3
valrie,0,1,0,1,0,2
tripping,1,1,1,0,1,4
milkman,0,1,0,0,0,1
vaisakhi,0,0,1,1,0,2
juste,2,2,2,1,2,9
goody,1,3,1,1,1,7
morro,0,2,0,1,1,4
drama,2,1,2,1,0,6
ounce,1,0,0,0,1,2
waltz,4,2,2,2,4,14
jimmy,2,1,0,0,1,4
aliens,1,0,0,0,0,1
framed,1,1,0,0,1,3
taiteilijan,1,0,0,0,1,2
fallin,0,1,0,1,1,3
sunshower,1,1,0,1,0,3
lesson,2,0,1,0,0,3
witchcraft,1,0,0,1,1,3
sengraisse,0,1,0,0,1,2
moulin,1,3,0,1,1,6
infected,2,0,2,1,2,7
forward,1,1,0,1,1,4
bored,1,0,0,0,0,1
skopska,0,0,0,1,0,1
getto,0,0,0,1,0,1
pimpin,2,0,0,1,1,4
tirols,0,1,0,1,1,3
murphy,0,1,1,0,1,3
boys,9,4,5,11,8,37
rcit,0,1,0,0,1,2
hopes,1,1,1,0,0,3
aviatic,1,1,0,0,1,3
groovy,1,1,1,1,1,5
laziest,1,1,0,0,1,3
planet,3,1,1,2,3,10
originale,0,0,0,0,1,1
jumbo,0,1,0,0,0,1
squarebiz,1,1,0,1,0,3
groove,4,3,2,2,3,14
knucklebuster,1,1,0,0,0,2
flow,1,3,1,0,1,6
single,13,7,5,8,8,41
cafe,2,1,0,2,0,5
obicham,1,0,0,0,1,2
fattasly,1,1,1,1,1,5
streit,0,0,0,1,0,1
terraplane,1,0,0,0,0,1
bubblegum,1,0,1,1,1,4
reputation,1,1,0,0,1,3
ellen,1,1,0,1,0,3
irreplaceable,1,1,0,0,1,3
wonderin,1,1,1,0,1,4
papi,1,0,0,1,1,3
amidar,1,1,1,1,1,5
gross,1,0,1,1,0,3
favourite,1,1,0,0,0,2
papa,4,3,0,1,3,11
yango,1,1,0,1,1,4
oedipus,0,0,0,0,3,3
fishes,1,1,0,0,1,3
desert,1,0,2,0,1,4
bohemios,1,0,0,0,1,2
trofimov,1,0,0,1,0,2
dixneuvime,0,0,0,1,0,1
malandro,1,1,0,1,0,3
presenting,0,1,0,0,1,2
fhrt,1,1,0,1,1,4
qian,0,0,0,0,1,1
groceries,1,0,0,0,0,1
vietnamese,1,0,1,0,0,2
peanut,0,1,0,0,0,1
makossa,0,1,0,0,0,1
bitomu,0,0,0,1,1,2
germain,0,1,0,1,0,2
intensiva,1,0,0,0,1,2
affettuoso,1,0,0,1,1,3
fatal,1,1,0,1,1,4
garou,1,1,1,1,1,5
joyride,1,0,0,1,1,3
saudade,1,1,0,1,1,4
rhyme,1,0,1,0,0,2
robbery,1,0,0,0,0,1
ausente,0,1,0,1,0,2
assai,1,0,0,1,1,3
knight,1,0,0,1,1,3
conc,0,0,0,0,1,1
joes,1,1,1,1,1,5
squarepants,1,0,0,1,1,3
mobilize,1,1,1,1,1,5
havent,1,0,1,0,0,2
delgaty,1,0,0,0,0,1
diluvio,0,0,0,0,1,1
bleeding,1,0,0,0,1,2
crow,2,1,1,1,1,6
tekee,1,0,0,0,1,2
carli,1,0,1,0,1,3
belleza,1,0,0,1,1,3
elisa,1,1,1,1,1,5
depression,1,0,0,0,1,2
lombre,0,1,0,1,0,2
chicago,5,3,2,2,4,16
anthem,2,0,1,3,3,9
emergencia,0,0,0,0,1,1
suruinen,1,1,0,0,1,3
denke,1,1,1,1,1,5
sicilienne,1,1,0,1,1,4
bullmoose,1,1,0,0,1,3
body,2,1,2,3,4,12
exchange,0,1,0,0,0,1
nonexistent,1,0,1,1,1,4
packing,1,0,0,0,0,1
healing,2,2,1,3,1,9
sing,4,6,1,3,7,21
nacht,4,1,1,4,4,14
cero,0,1,0,1,0,2
garcon,1,0,0,0,1,2
climb,1,0,0,0,0,1
named,1,0,0,0,1,2
presidents,1,0,0,1,0,2
marelle,1,1,1,1,1,5
private,1,1,0,1,1,4
neuza,0,0,0,1,0,1
limn,1,0,0,1,0,2
resolutions,1,0,0,0,1,2
gateway,1,0,0,1,1,3
sermon,1,1,1,1,1,5
cierro,1,0,1,1,1,4
hammered,0,1,0,1,0,2
laventurier,1,1,0,1,1,4
popsy,0,1,0,0,1,2
emmaus,0,0,0,1,0,1
astoria,1,0,1,0,1,3
train,17,10,8,10,14,59
pirame,1,0,0,1,1,3
tearing,1,0,0,0,1,2
harvest,0,1,0,0,0,1
spaniolandia,0,0,0,1,0,1
fooling,2,2,0,1,2,7
espagnole,1,1,0,1,1,4
britney,1,0,1,0,1,3
tunnel,2,0,2,0,1,5
gabriel,1,0,0,1,1,3
obvious,1,1,1,0,0,3
praise,0,1,0,1,0,2
closing,1,0,0,1,1,3
didnt,7,2,4,1,1,15
athenry,1,0,0,1,0,2
precs,1,0,1,0,0,2
twilliams,0,0,0,1,0,1
scarface,1,0,0,0,1,2
chakra,2,2,0,2,0,6
globillyveevee,0,1,0,0,0,1
native,0,1,0,1,0,2
voini,1,0,0,1,0,2
bakwetu,1,1,0,1,1,4
noises,1,1,1,0,0,3
boxing,1,0,1,0,1,3
forest,3,2,2,2,2,11
stasis,1,0,0,0,0,1
falta,3,0,2,1,3,9
autobiography,0,1,0,0,1,2
waters,1,1,1,1,0,4
collection,0,1,0,0,1,2
bothered,1,0,0,0,1,2
bluff,0,0,1,0,0,1
klan,1,1,0,0,1,3
gammal,1,0,0,0,0,1
kashmiri,0,0,0,0,1,1
chasing,3,2,2,2,3,12
kuang,0,1,0,0,1,2
bing,1,0,1,0,0,2
itsy,1,0,1,1,1,4
bina,0,0,0,1,0,1
piacere,1,0,0,0,1,2
querido,0,0,0,1,1,2
laurie,0,1,0,0,1,2
likua,1,0,0,0,1,2
lucindy,1,0,0,0,1,2
chteau,1,1,1,1,1,5
horns,2,2,1,2,2,9
thyself,1,0,1,1,0,3
johanna,1,0,0,0,1,2
galaxy,1,0,0,1,1,3
bunch,1,1,0,1,1,4
bridges,1,1,0,1,1,4
bridget,1,1,0,0,1,3
brian,0,1,0,0,1,2
sporco,2,2,0,2,2,8
winning,1,1,1,1,0,4
pginas,0,0,0,0,1,1
junction,1,0,0,1,0,2
greater,0,0,0,1,0,1
spell,1,2,0,0,0,3
mambazo,1,1,0,0,1,3
blessed,1,0,0,0,1,2
volant,0,0,0,0,1,1
cutting,1,0,1,0,0,2
legged,1,1,0,0,0,2
sonata,2,0,0,2,2,6
february,1,1,0,0,1,3
thrill,3,1,1,2,3,10
recuerdo,1,0,0,0,1,2
slipping,2,1,2,2,2,9
lively,1,1,0,0,1,3
dixie,1,1,0,0,2,4
dreaming,3,1,2,2,3,11
programmed,0,0,1,0,0,1
drumroll,1,1,1,1,0,4
junkie,2,1,1,0,2,6
firebirdapparition,0,1,0,0,0,1
manteca,0,1,0,1,0,2
defend,1,0,0,0,1,2
jamaiquino,0,1,0,1,0,2
mate,1,1,0,1,0,3
ridaz,1,1,0,1,1,4
frank,3,2,1,2,4,12
compra,1,1,1,1,1,5
bleed,2,0,2,0,2,6
midn,1,1,0,1,1,4
yard,1,0,0,0,1,2
seor,1,0,0,0,1,2
deprived,1,0,1,1,0,3
south,4,3,1,3,1,12
suffit,0,0,0,0,1,1
philadelphia,1,0,0,0,1,2
franks,1,0,0,1,0,2
hillcrest,1,0,0,0,0,1
bezell,0,0,0,1,0,1
monkey,5,3,1,3,2,14
dutty,0,0,0,1,0,1
tropeau,0,1,0,1,1,3
roche,1,1,0,0,1,3
palestine,0,0,1,0,1,2
jingle,3,1,0,0,3,7
parchman,2,1,2,2,0,7
natty,0,0,0,1,0,1
dichoso,1,1,0,1,1,4
negra,0,0,0,0,1,1
gear,1,0,1,1,1,4
nieman,1,1,1,1,1,5
bulldog,1,1,0,1,0,3
nobody,5,2,0,2,4,13
highlands,1,0,0,0,1,2
oaktown,1,0,1,0,0,2
boobie,0,0,1,0,0,1
fabbricaeuropa,0,0,0,1,0,1
wishlist,1,0,1,0,1,3
skyswimmer,1,0,1,1,0,3
abstracto,1,0,1,0,1,3
loved,6,2,1,2,6,17
babys,4,2,0,2,3,11
slack,1,0,1,0,0,2
cantares,1,0,1,1,1,4
cancon,0,0,0,1,1,2
desiguais,1,1,0,1,1,4
drunnhvita,0,1,0,1,0,2
loves,10,7,5,6,8,36
lover,10,6,3,10,9,38
flashes,1,1,0,1,0,3
inna,1,0,0,1,0,2
wakes,0,1,0,1,0,2
nativit,0,1,0,1,0,2
recuso,1,1,0,0,1,3
tide,3,2,2,3,4,14
thataway,1,0,0,1,0,2
have,28,21,13,19,23,104
dementia,1,0,1,1,0,3
dallas,1,0,0,0,0,1
cuore,1,1,0,1,1,4
precipice,0,1,0,1,0,2
espana,1,1,1,1,1,5
eres,0,2,0,0,1,3
tromba,1,0,0,0,1,2
henrys,1,0,0,1,0,2
eight,2,1,1,1,2,7
vollmond,1,0,0,0,0,1
sally,3,0,2,1,2,8
jaan,0,0,1,1,1,3
unlove,0,0,0,0,1,1
gigue,1,1,0,0,1,3
shouther,0,2,0,0,0,2
stranded,1,0,1,0,0,2
request,1,0,0,0,1,2
disease,1,0,1,0,0,2
tenhert,1,0,1,0,0,2
rendezvous,1,0,1,1,1,4
skinny,0,1,0,0,0,1
capito,0,0,0,1,0,1
elevador,1,1,1,1,1,5
charley,0,1,0,0,1,2
kite,1,1,1,1,1,5
rytmikone,1,0,1,0,1,3
ithaki,0,0,0,0,1,1
chiaroscuro,0,0,0,1,0,1
kakou,1,1,0,1,1,4
sparky,1,1,1,1,1,5
knowledge,2,1,0,2,1,6
blowin,1,1,0,0,0,2
epilog,1,0,1,0,1,3
anythings,0,0,0,0,1,1
bernard,1,1,0,0,0,2
satan,1,1,0,1,1,4
annaleah,1,0,1,0,1,3
inferior,1,0,1,0,1,3
photographs,1,0,0,1,1,3
beat,8,5,5,6,7,31
loba,1,0,0,0,1,2
souvre,1,0,0,0,1,2
bear,2,0,0,1,2,5
beam,0,1,0,1,1,3
bean,2,2,2,2,2,10
october,1,1,1,1,1,5
perfection,1,0,0,1,0,2
assface,1,0,0,0,1,2
diplo,0,0,0,1,0,1
organ,1,0,0,0,1,2
rage,1,0,0,0,0,1
calling,2,1,2,3,2,10
rakkauden,2,1,1,0,2,6
constructing,0,0,0,1,0,1
national,0,1,0,1,1,3
machuca,1,0,0,0,1,2
frierson,1,1,0,0,1,3
brixton,1,0,1,1,0,3
existe,1,1,0,1,1,4
yearning,1,0,0,0,1,2
intensity,1,0,1,0,0,2
shte,1,0,0,0,1,2
walking,7,4,0,6,7,24
epic,1,0,0,1,1,3
epaule,1,0,1,1,1,4
lupe,1,0,0,0,1,2
bruno,1,0,0,0,0,1
playboys,1,1,0,1,1,4
progress,0,0,0,1,1,2
waheera,0,1,0,0,0,1
instumental,1,0,1,0,1,3
janes,2,0,0,1,1,4
janet,0,0,0,0,1,1
junkies,1,0,1,1,0,3
sorrow,2,1,1,1,0,5
monarchy,1,1,0,1,1,4
herione,1,0,0,0,1,2
habanera,0,1,0,1,0,2
prtention,1,0,1,1,1,4
joke,1,0,0,0,0,1
taking,1,0,0,0,0,1
conmigo,2,1,1,1,2,7
succotash,1,0,1,1,0,3
tates,1,0,1,1,1,4
busted,1,1,0,0,1,3
orfeo,1,1,0,0,0,2
usurperescapemartyrspiral,1,1,0,0,0,2
swallow,1,0,0,0,0,1
highland,1,1,0,1,1,4
vent,1,0,0,1,0,2
starspangled,1,1,0,0,1,3
agrymonyzer,0,0,0,1,0,1
eriatarka,1,0,1,1,0,3
reborn,2,0,1,1,0,4
vena,1,1,0,1,0,3
laugh,3,1,3,3,3,13
cendrier,1,0,0,1,1,3
delirio,1,2,0,0,1,4
muddy,1,0,0,1,0,2
gaze,1,1,1,0,1,4
arteest,1,0,0,0,1,2
rammembri,1,0,0,0,1,2
yesterdays,2,4,1,3,4,14
protect,0,0,0,1,0,1
tenderly,2,2,0,0,2,6
tense,1,0,1,0,0,2
mundo,1,0,0,0,1,2
bull,4,4,2,3,4,17
waterhole,1,0,0,1,0,2
blacksun,1,0,0,1,0,2
cypher,1,1,1,1,1,5
brasilia,1,1,0,1,1,4
widescreen,1,0,0,1,1,3
elisabetta,1,0,0,0,1,2
techtonic,0,1,0,1,0,2
helper,1,0,1,0,1,3
almost,2,4,2,1,2,11
weighed,1,0,0,1,1,3
belina,0,1,0,1,1,3
palavras,0,1,0,0,0,1
partner,5,2,0,3,2,12
fezbeing,1,1,1,1,1,5
plexis,0,1,0,0,0,1
tiempo,1,1,0,0,1,3
material,1,0,1,0,0,2
sizofrenijaduet,0,0,0,0,1,1
spitting,1,0,1,0,1,3
fucked,1,0,0,0,1,2
sigui,0,1,0,1,1,3
sete,1,1,0,1,1,4
eurydice,1,0,0,1,1,3
center,2,0,1,1,2,6
weapon,2,2,0,1,0,5
rapino,1,1,1,1,1,5
thought,1,1,1,1,1,5
position,1,0,1,1,0,3
wreckage,1,0,1,0,1,3
barking,1,0,0,1,1,3
damour,2,2,0,1,4,9
xian,0,0,0,1,1,2
abai,0,1,0,1,0,2
oracin,1,0,1,1,1,4
underlying,1,0,0,1,1,3
books,2,0,0,0,1,3
situacija,0,0,0,1,0,1
quiero,6,2,2,5,8,23
loquillo,1,0,1,0,1,3
chorinho,2,2,2,2,2,10
quiere,0,0,0,0,1,1
smpty,1,0,0,1,0,2
lake,1,0,1,4,2,8
cybernetic,1,0,1,1,1,4
monnaie,0,1,0,0,1,2
citizen,1,0,0,1,1,3
twerk,0,1,0,1,1,3
crass,2,1,0,0,2,5
tonk,1,1,0,1,1,4
smart,1,1,0,0,1,3
worlds,2,1,1,1,1,6
steklu,0,0,0,1,1,2
cicatriz,1,0,1,1,1,4
jonki,1,0,0,0,1,2
like,44,27,23,32,38,164
success,1,1,0,1,1,4
darcy,0,1,0,0,1,2
chica,1,1,0,1,1,4
cantando,1,1,0,0,0,2
sarajevo,1,0,0,1,1,3
pyar,0,0,0,1,0,1
chick,1,0,1,1,0,3
works,1,0,0,0,0,1
leducation,1,1,0,0,1,3
chico,0,0,0,0,1,1
italian,0,0,0,1,1,2
tetaz,1,0,0,1,1,3
alive,9,3,4,6,8,30
hair,2,0,1,2,2,7
manigances,1,1,1,1,1,5
oblivious,1,0,1,0,0,2
happens,1,0,1,1,0,3
coombe,1,1,0,0,1,3
hurricane,1,0,0,1,1,3
rattlesnake,1,1,1,0,1,4
joachim,0,1,0,1,1,3
wout,1,1,0,1,1,4
quinze,0,1,0,0,1,2
screwed,0,0,0,0,4,4
chains,3,1,0,2,4,10
rumpu,0,0,0,0,1,1
slight,2,2,1,1,1,7
sasha,1,1,1,1,1,5
expire,1,0,1,1,1,4
retribution,1,1,1,1,1,5
about,16,9,4,9,14,52
quills,1,1,0,1,1,4
boards,1,0,0,1,0,2
flake,1,0,1,0,1,3
flashflood,0,1,0,1,1,3
turandot,1,0,0,1,0,2
tomb,1,0,1,1,1,4
alexanders,0,1,0,0,1,2
unreleased,2,1,1,1,1,6
faithfulness,3,3,2,3,2,13
childrens,0,1,0,0,0,1
obliterated,1,1,0,1,1,4
socks,1,0,0,0,1,2
guard,0,0,0,0,1,1
doesnt,3,1,2,1,3,10
eine,1,0,0,1,1,3
eshiha,0,0,1,1,1,3
termina,1,1,0,1,1,4
timbal,1,1,0,1,0,3
daubrac,0,1,0,0,1,2
yorkers,1,0,0,1,0,2
stainless,1,0,0,0,1,2
toutes,1,1,0,1,1,4
banzai,1,0,0,1,0,2
rushes,0,0,0,1,0,1
oiseaux,2,0,1,1,2,6
lamboy,1,0,0,1,1,3
chlore,1,0,1,1,1,4
dieters,1,0,0,1,1,3
ivory,2,0,2,1,0,5
coke,1,0,1,0,1,3
sequel,1,1,0,0,0,2
santas,1,1,0,1,0,3
plague,1,0,1,0,0,2
santaf,0,0,0,0,1,1
memphis,5,5,4,2,6,22
seis,0,1,0,0,0,1
misty,4,1,0,2,3,10
ageya,0,0,0,0,1,1
glory,6,4,3,3,3,19
seit,1,0,1,1,1,4
caminante,0,1,0,1,0,2
variations,4,0,0,4,6,14
byob,0,0,0,1,1,2
veteraani,1,0,1,0,1,3
minutes,3,1,1,1,3,9
sein,3,1,1,1,1,7
supreme,0,0,1,0,1,2
garter,1,0,0,1,1,3
domino,1,0,0,0,1,2
crusade,0,2,0,2,2,6
barnyards,1,0,0,0,0,1
baos,1,1,0,1,1,4
mash,1,0,0,1,1,3
dressed,0,1,0,0,0,1
mast,0,0,0,0,1,1
balao,1,1,0,1,0,3
stocne,1,1,1,0,1,4
shouldve,1,0,0,0,1,2
variation,3,2,1,3,2,11
westlate,0,2,0,0,0,2
bitsy,1,0,1,1,1,4
goin,7,3,3,2,6,21
baker,1,0,0,1,1,3
cuycha,0,1,0,0,0,1
yell,1,0,0,0,0,1
kinghead,1,1,0,1,1,4
sleep,3,0,1,1,1,6
nosatellites,0,0,1,1,0,2
dere,0,1,0,1,1,3
veux,1,1,1,1,1,5
trolley,1,1,0,0,1,3
paris,5,5,2,6,4,22
tween,1,0,0,1,1,3
posledny,1,0,0,1,0,2
under,10,5,4,7,7,33
regrets,3,1,2,3,3,12
haughtiness,1,0,1,1,1,4
rise,6,2,2,2,3,15
every,7,1,4,4,5,21
jack,6,4,4,4,6,24
caput,0,0,0,0,1,1
yodel,1,1,0,0,0,2
cerillas,0,1,0,0,1,2
monkeys,1,0,0,0,0,1
missionary,1,0,0,1,1,3
trascorrono,0,0,0,0,1,1
school,3,1,2,1,0,7
soundtracks,1,1,0,1,0,3
anfang,1,0,1,1,1,4
venus,1,0,1,1,1,4
decidio,1,1,0,1,1,4
pooley,0,0,0,1,1,2
enjoy,3,0,3,0,3,9
throught,1,0,1,0,1,3
nail,1,1,0,0,0,2
lian,1,0,0,0,1,2
street,17,10,2,10,11,50
matrosen,1,0,1,1,0,3
shining,3,1,1,3,1,9
blue,29,16,8,19,25,97
hide,1,1,0,0,1,3
christ,2,0,1,2,2,7
kaotica,1,0,0,1,1,3
lenfant,0,1,0,1,0,2
revolver,1,0,0,0,1,2
liberty,1,0,1,1,1,4
sung,3,0,0,0,3,6
liberte,0,0,1,1,1,3
xvii,1,0,0,1,1,3
nubia,1,1,1,1,1,5
impartial,1,0,1,1,1,4
zack,1,1,0,1,1,4
molly,1,0,0,0,1,2
shontelle,1,1,1,1,1,5
pata,2,2,0,2,2,8
studio,3,1,1,1,2,8
lero,0,1,0,0,0,1
aftermath,1,0,1,0,0,2
stares,1,0,1,1,0,3
biloxi,1,0,0,0,0,1
tinsel,1,0,1,1,0,3
exactamente,1,1,0,0,1,3
leaves,2,2,0,2,2,8
changed,3,1,1,1,3,9
amante,0,0,0,0,1,1
populaire,0,0,0,0,1,1
chateau,1,0,0,0,0,1
changes,2,1,1,2,2,8
agrippina,1,0,0,0,1,2
straw,1,1,1,2,2,7
gwine,0,0,0,1,0,1
loveless,1,0,0,1,1,3
feelings,0,1,0,2,2,5
sorrows,1,0,0,1,0,2
patience,1,0,1,1,1,4
outro,9,3,1,7,4,24
rhumboso,0,1,0,1,0,2
would,6,5,4,2,4,21
bayou,2,0,0,1,1,4
christelle,1,1,1,1,1,5
breathe,3,2,0,1,2,8
sabes,1,1,0,0,0,2
muse,1,0,0,0,0,1
comfortubly,1,1,0,1,1,4
phone,3,2,2,2,2,11
sting,3,1,1,2,2,9
cuttin,1,1,1,1,1,5
organic,0,1,0,0,0,1
bambola,1,0,0,0,1,2
coppershot,1,0,1,1,1,4
must,6,2,2,3,5,18
shoot,5,1,1,2,6,15
join,1,0,1,1,0,3
lukas,0,0,0,0,1,1
grandpno,1,1,1,1,1,5
everafter,1,1,0,0,1,3
fortress,1,0,0,1,1,3
estate,0,2,0,1,1,4
gwendolina,1,1,0,1,1,4
potria,1,0,0,1,0,2
ratkaisee,1,1,1,1,1,5
rakastan,1,0,0,0,0,1
times,10,6,3,3,5,27
rakastaa,0,0,0,1,1,2
ceremony,1,1,1,0,1,4
billville,0,1,1,0,0,2
iiii,1,1,1,1,0,4
drummer,2,2,1,1,0,6
gate,2,0,0,0,1,3
labios,1,0,0,0,1,2
poker,1,0,0,1,1,3
elizabeth,1,1,0,0,0,2
mess,2,0,1,1,1,5
jumping,2,1,2,2,1,8
salsa,0,2,0,2,4,8
parallel,1,1,1,0,1,4
danny,2,1,0,0,2,5
amie,1,0,0,0,1,2
upside,1,0,1,0,1,3
jungle,6,3,5,5,2,21
suerte,0,0,0,0,1,1
harlem,4,3,1,1,4,13
amis,1,1,1,1,1,5
friars,1,1,0,0,1,3
deform,1,0,1,1,0,3
over,24,16,14,18,24,96
chowbay,1,1,1,1,1,5
historys,1,1,1,1,0,4
london,1,0,0,1,1,3
crumbs,1,0,1,1,0,3
mallarm,0,0,0,1,0,1
asesname,1,0,1,1,1,4
pkin,1,0,0,0,1,2
lantillais,0,0,0,1,1,2
canta,2,1,1,0,2,6
hypocrisy,1,0,1,0,0,2
canto,1,1,0,1,1,4
edith,1,1,0,0,0,2
baila,2,0,0,2,1,5
writing,1,1,0,0,0,2
creepshow,1,0,0,1,1,3
nuoruusmuistoja,1,1,0,0,1,3
fade,4,0,1,1,4,10
fofo,1,0,0,0,1,2
riff,1,0,0,0,1,2
blott,0,1,0,0,0,1
suene,0,1,0,0,0,1
revelations,3,2,2,2,2,11
lento,2,0,2,2,2,8
shadows,3,2,1,3,2,11
alex,1,1,1,1,1,5
mammas,0,1,0,0,1,2
detroit,3,1,2,4,4,14
explode,3,1,2,2,2,10
holdin,2,1,1,1,1,6
each,5,1,3,3,3,15
victors,0,1,0,0,1,2
hank,3,0,2,2,3,10
diana,2,2,1,0,1,6
moose,1,1,0,1,0,3
group,1,0,0,0,1,2
autre,1,0,1,1,1,4
loafting,0,0,0,1,0,1
hanged,1,0,0,0,0,1
ghosts,2,1,2,0,0,5
saturday,6,1,3,4,6,20
driving,3,2,1,3,3,12
motel,1,0,0,1,0,2
washed,1,1,1,1,1,5
duction,1,1,0,1,1,4
mayday,1,0,0,0,0,1
nite,2,0,0,2,1,5
heavenly,2,2,2,2,1,9
washes,1,1,1,1,1,5
reja,0,1,0,0,0,1
independence,1,0,0,0,1,2
frei,2,0,0,0,0,2
perception,1,1,1,1,1,5
carcass,1,0,1,0,0,2
gammer,1,0,1,1,1,4
eternal,1,0,1,0,0,2
free,12,7,7,8,9,43
fred,1,0,0,0,1,2
begleiten,1,1,1,1,1,5
streamline,1,0,0,0,1,2
rain,19,8,11,8,15,61
netait,1,1,0,1,1,4
wanted,2,0,1,3,1,7
dabdabdooparty,1,0,0,1,1,3
baals,1,1,1,1,1,5
days,22,11,8,10,16,67
soda,2,0,0,0,1,3
shootin,1,1,1,1,1,5
marwa,1,0,0,1,1,3
rang,0,0,0,1,1,2
magico,1,0,1,0,1,3
puck,0,0,1,0,0,1
primary,1,0,1,0,0,2
fantasy,0,0,0,1,1,2
sober,1,1,0,0,1,3
aikaa,1,0,0,1,1,3
dysfunction,0,1,0,1,0,2
mercury,2,1,1,2,0,6
lovebite,1,0,0,1,1,3
attack,4,3,0,4,3,14
hustlin,1,0,0,0,0,1
rockin,3,2,1,1,2,9
firestarter,1,0,1,1,1,4
urban,0,0,0,1,0,1
murder,5,2,4,4,4,19
indiscreet,0,1,0,0,0,1
serve,1,0,1,1,0,3
took,3,3,0,3,2,11
western,2,0,0,0,1,3
litler,1,1,1,1,1,5
scenario,1,1,0,0,1,3
flama,0,0,0,0,1,1
flame,3,1,0,2,0,6
olerkia,0,0,0,0,1,1
guaguanco,1,1,0,0,0,2
bridge,2,2,0,2,4,10
talking,4,3,2,4,3,16
clubstar,1,0,1,1,1,4
snow,3,4,2,1,3,13
bleib,1,0,0,1,1,3
maxi,1,0,1,1,1,4
derek,1,1,0,1,1,4
shelf,1,0,0,0,1,2
snob,1,1,0,1,1,4
sparro,0,1,0,1,1,3
rider,1,1,0,1,1,4
dial,0,0,0,1,0,1
excelling,0,1,0,0,1,2
passover,1,0,0,1,1,3
coil,1,0,1,1,0,3
tibetan,0,1,0,1,0,2
glow,2,1,2,1,2,8
flor,1,0,0,1,2,4
kleine,2,1,0,2,2,7
metal,2,0,3,1,2,8
kleina,0,0,0,1,0,1
yang,0,0,0,1,2,3
cambia,1,1,1,1,0,4
velarde,1,0,0,0,1,2
sanctuary,1,0,0,0,0,1
coeur,4,2,1,3,4,14
saga,0,1,0,1,0,2
queen,5,1,2,4,5,17
colors,0,0,0,1,0,1
reissue,2,0,0,0,0,2
radio,15,8,10,15,18,66
earth,10,5,4,4,8,31
sagt,1,1,1,1,1,5
adoration,0,1,0,0,0,1
claude,1,1,1,1,1,5
situations,0,0,0,1,0,1
farenheit,0,0,0,1,0,1
stephane,0,0,0,1,0,1
gods,1,1,0,1,1,4
sedona,0,0,0,1,0,1
getdown,0,0,0,1,0,1
mixture,1,0,1,1,1,4
watch,2,2,1,2,2,9
fluid,2,2,0,1,1,6
geek,1,1,0,0,0,2
goons,1,0,0,0,1,2
wedding,4,3,0,1,3,11
rhymin,1,1,1,0,0,3
goodbyes,1,0,1,1,0,3
reminissin,0,0,0,1,1,2
public,1,0,1,0,0,2
peroxide,0,1,0,0,1,2
automatic,1,0,0,0,1,2
habit,1,0,0,0,0,1
resist,1,1,0,1,1,4
machst,1,0,0,1,1,3
bonnies,0,1,0,0,1,2
hourglass,1,0,1,1,0,3
combustion,1,1,0,1,1,4
malice,1,0,0,0,0,1
hoedown,1,1,1,1,1,5
finger,2,0,0,1,2,5
oniro,1,0,0,0,1,2
cajun,5,2,1,0,4,12
blaster,1,1,1,1,1,5
confusion,1,0,1,1,1,4
weak,1,0,0,0,0,1
boss,1,1,0,1,2,5
wear,2,2,1,2,2,9
badrock,1,0,1,1,1,4
news,1,0,0,0,0,1
hills,1,1,0,2,0,4
faced,1,1,0,0,0,2
goddess,2,1,0,1,1,5
fault,1,1,1,1,1,5
players,0,0,0,1,0,1
games,2,2,1,0,4,9
rpido,1,0,1,1,1,4
faces,1,1,1,1,1,5
amarela,1,1,0,0,1,3
trust,3,2,1,2,3,11
hitler,1,0,0,0,1,2
bathroom,1,0,0,0,1,2
alchemy,1,1,0,0,1,3
been,13,8,2,6,12,41
backlash,0,0,0,1,0,1
beer,1,1,0,0,1,3
tenemos,1,0,0,0,1,2
drillrework,1,1,1,1,1,5
corazn,3,2,2,2,2,11
fleeting,0,0,0,1,0,1
drugs,1,0,1,1,0,3
steamroller,1,0,0,0,1,2
krause,1,1,0,1,0,3
catch,2,0,0,0,1,3
dept,1,0,1,1,1,4
teachers,1,0,1,0,1,3
stopping,1,1,1,0,1,4
cracked,1,0,1,1,0,3
gave,2,1,1,1,2,7
lebaran,1,0,0,1,0,2
ciganos,0,1,0,0,0,1
veronica,1,0,0,0,1,2
runaround,1,0,0,0,1,2
kcrw,1,0,1,0,0,2
madres,0,0,0,1,1,2
opelousas,1,0,0,0,1,2
latinas,1,1,0,1,1,4
shawty,0,0,0,1,0,1
satellite,1,1,1,1,1,5
maubeuge,0,0,0,1,1,2
negativ,0,0,0,1,0,1
theodore,0,1,0,0,1,2
milky,1,1,0,0,0,2
hundre,1,0,0,0,0,1
action,3,0,2,1,2,8
saintjean,0,1,0,0,1,2
angle,1,0,0,0,1,2
viimeinen,1,0,1,1,1,4
cycle,1,0,0,1,1,3
dylan,2,1,0,1,2,6
giorgi,1,0,0,1,1,3
charlie,2,1,2,1,1,7
ocean,8,4,6,5,5,28
strangerhood,1,0,1,1,0,3
greatest,3,2,1,0,2,8
rockout,1,0,1,1,0,3
mother,9,5,3,5,9,31
hearts,8,4,4,6,8,30
jean,4,2,0,2,4,12
rubies,1,1,0,1,1,4
amame,0,0,0,0,1,1
zolte,1,0,1,1,1,4
frlskad,1,1,0,0,1,3
tetrispack,0,0,0,1,0,1
sabados,1,0,1,0,1,3
scorpio,1,1,0,1,1,4
cherry,3,0,1,3,3,10
chaudrons,0,1,0,0,0,1
flashover,0,1,0,1,1,3
humanity,1,0,1,1,0,3
anya,0,1,0,0,1,2
turquoise,0,1,0,1,0,2
breakz,1,0,1,1,1,4
hermitage,1,1,0,0,0,2
breaks,2,1,0,1,1,5
vulture,1,0,1,1,0,3
cultural,1,1,0,1,1,4
espressivo,1,0,0,1,1,3
judge,1,0,0,0,0,1
banda,2,1,0,1,2,6
apart,0,2,0,1,1,4
melting,1,0,1,1,1,4
everrett,1,1,0,1,1,4
appearing,1,0,0,1,1,3
gift,1,1,0,0,1,3
mosquito,1,0,1,1,0,3
hung,1,0,0,0,0,1
amor,18,9,3,9,19,58
larghetto,1,0,1,0,1,3
clubb,1,0,0,1,1,3
acab,1,0,0,0,0,1
spongebob,1,0,0,1,1,3
excerpt,0,0,0,0,1,1
pushbike,1,1,1,1,1,5
escape,4,2,1,1,3,11
skymning,1,0,0,1,0,2
eugenes,1,1,1,1,1,5
stumblin,1,0,1,1,1,4
everything,13,6,7,9,12,47
christmas,23,11,6,12,21,73
triste,2,1,0,0,1,4
sukkubus,1,0,0,1,0,2
coro,1,0,0,0,2,3
disappeared,1,1,1,1,1,5
maschinenkult,1,0,0,1,0,2
chapter,2,0,0,0,0,2
cowboy,2,1,1,1,2,7
sepa,1,0,0,0,1,2
choke,1,0,0,0,0,1
dinner,1,1,0,1,1,4
plus,6,5,3,6,6,26
mismo,1,0,1,1,1,4
sept,1,1,0,1,1,4
mortva,1,0,1,0,0,2
duke,1,0,1,0,1,3
bata,0,1,0,0,1,2
civic,1,0,1,0,0,2
puzzle,1,1,1,1,1,5
gham,0,0,0,1,0,1
bath,2,1,0,1,3,7
javas,0,1,0,1,1,3
nihilo,1,0,0,0,0,1
piouhgd,1,0,0,1,1,3
dreamin,1,1,1,1,1,5
stuck,4,1,2,3,2,12
anderson,0,0,0,0,1,1
wildflower,1,0,0,0,1,2
ilbert,1,1,0,1,1,4
head,20,10,5,12,15,62
medium,2,0,0,0,2,4
traidor,1,0,1,0,1,3
heal,2,0,2,2,2,8
schauet,1,1,1,1,1,5
heat,1,0,1,0,0,2
uncle,1,1,1,1,0,4
solas,1,1,1,1,0,4
bernice,1,0,1,0,1,3
viva,0,0,0,0,1,1
witchdoctor,1,1,0,1,1,4
vivo,4,0,1,1,3,9
versione,0,0,1,1,0,2
adore,1,1,0,1,1,4
atto,1,0,0,1,2,4
arabes,1,1,0,0,0,2
camara,1,1,0,0,0,2
brisa,0,1,0,0,0,1
raha,1,1,1,1,1,5
micael,1,0,1,1,1,4
fury,1,1,1,1,1,5
honeybabe,1,1,0,0,0,2
bulgarian,1,0,0,0,1,2
traviata,1,0,0,1,0,2
sometime,1,1,0,0,1,3
cocain,1,0,0,1,0,2
acclaimed,1,0,1,1,1,4
juntos,0,0,0,0,1,1
shines,3,1,3,1,3,11
check,2,3,0,3,2,10
junto,1,0,0,1,2,4
damisela,0,1,0,0,0,1
faithful,1,3,0,1,0,5
marys,1,1,0,1,1,4
mashup,1,0,0,1,0,2
percaria,0,1,0,0,0,1
when,42,19,14,23,32,130
desce,0,1,0,0,0,1
setting,1,1,0,1,0,3
papers,1,1,0,0,1,3
evergreen,1,0,1,1,1,4
picture,1,1,0,1,1,4
brivdiena,1,1,0,0,1,3
tarraxa,0,0,0,1,0,1
eiffel,1,0,0,1,1,3
discharge,1,1,0,0,1,3
scratchy,1,0,0,0,1,2
siento,1,1,1,1,0,4
sellack,1,1,0,0,1,3
faster,2,2,0,1,1,6
bullet,2,2,1,2,1,8
ryder,1,1,1,1,1,5
juguete,1,1,1,1,0,4
bamba,1,1,0,1,1,4
jolson,1,1,0,0,0,2
focus,0,1,0,2,1,4
cancion,4,0,2,3,2,11
finisterre,1,0,0,1,1,3
passage,2,1,0,2,1,6
eisbr,1,1,1,1,1,5
verliebt,1,1,1,1,1,5
fuiste,1,0,1,0,1,3
frequencies,0,1,0,1,0,2
krazy,2,1,0,1,1,5
none,1,0,1,1,0,3
sloppy,2,0,1,1,2,6
vestido,1,0,0,0,1,2
deirdre,0,1,0,1,0,2
cool,9,6,1,5,7,28
clouds,1,0,0,1,0,2
valentin,1,0,0,1,0,2
brother,9,3,3,3,4,22
levee,1,0,0,0,0,1
youngs,1,0,0,0,1,2
espanol,0,0,0,1,1,2
quick,1,0,0,0,1,2
yall,1,0,0,0,0,1
sanguinis,1,1,0,1,1,4
says,5,3,3,4,4,19
exsvles,1,0,1,0,0,2
confiaste,1,0,0,1,0,2
colin,2,1,0,2,0,5
steppin,2,2,1,1,1,7
voucher,1,0,1,0,0,2
chicken,1,0,1,1,1,4
phorever,1,0,1,1,1,4
hymn,3,2,1,3,2,11
corba,0,1,0,0,1,2
seule,1,1,1,1,1,5
goes,6,4,1,6,7,24
reply,1,0,0,1,1,3
ayee,1,1,1,1,1,5
water,6,4,0,2,4,16
witch,1,0,1,0,0,2
boogaloo,1,3,0,2,1,7
aunque,1,1,1,0,0,3
unidentified,1,1,1,1,1,5
regnen,1,1,1,1,1,5
automator,1,0,0,0,1,2
pearls,1,1,0,1,1,4
guilty,2,0,0,2,2,6
molto,1,1,0,1,1,4
cinnamon,1,0,1,0,0,2
emerge,1,0,1,0,0,2
pusfilled,1,0,1,0,0,2
tempteth,0,0,1,0,1,2
ethiopian,0,0,0,1,0,1
paralyzed,1,1,1,1,1,5
prem,1,1,0,1,1,4
kalanta,1,0,0,0,1,2
stephin,1,0,0,1,1,3
sports,1,1,0,0,1,3
parties,1,0,0,0,0,1
vivir,1,0,0,1,0,2
andy,1,0,1,1,1,4
memory,2,1,0,2,3,8
megaton,0,1,0,0,1,2
australian,1,1,0,0,1,3
today,4,1,3,3,2,13
riot,3,1,3,0,1,8
sessions,2,0,1,1,1,5
altas,1,0,0,1,1,3
altar,1,1,1,1,1,5
ayer,2,0,0,2,1,5
chocolate,1,0,1,0,1,3
drown,1,2,0,0,2,5
aragn,0,2,0,0,0,2
prophecy,1,1,0,2,1,5
survivalism,1,0,1,1,1,4
matarlatanta,0,0,0,0,1,1
yves,0,0,0,1,0,1
daimer,1,1,0,1,1,4
meathead,1,0,0,0,0,1
bourre,1,2,0,0,1,4
biancas,1,1,0,1,1,4
laughter,3,1,2,1,3,10
mouvement,0,0,0,1,0,1
streak,1,0,0,1,0,2
amalgama,0,0,0,1,0,1
desierta,0,0,0,0,1,1
stream,1,1,0,1,1,4
performed,4,0,0,0,0,4
juoksuhaudoissa,1,0,0,1,0,2
sidney,1,0,1,1,1,4
dress,3,2,1,2,2,10
sundance,1,1,0,1,1,4
fourth,0,0,0,1,0,1
algn,1,0,1,1,1,4
begs,1,1,0,1,1,4
glissez,0,1,0,1,0,2
informa,1,0,0,1,1,3
ballroom,2,2,1,1,2,8
fascist,2,2,2,2,2,10
primeira,1,1,0,1,1,4
namorada,0,1,0,0,1,2
jaguars,1,0,1,1,0,3
birthday,1,0,0,0,0,1
liquid,2,4,2,4,1,13
rollin,3,3,1,1,1,9
arrete,0,0,0,2,0,2
fleetwood,0,0,1,0,0,1
infantes,1,0,0,0,1,2
exclusive,1,1,0,0,1,3
manera,0,0,0,0,1,1
midnight,14,11,3,11,9,48
worship,2,0,1,1,1,5
bacan,1,1,0,1,1,4
swang,0,0,0,0,1,1
subsurface,0,1,0,0,0,1
swans,0,0,0,1,0,1
whirlpool,2,2,1,2,2,9
lonely,9,4,3,5,11,32
nomads,1,0,0,1,0,2
tulip,0,0,0,0,1,1
conquer,1,0,1,1,1,4
grial,1,0,1,1,0,3
name,8,3,5,5,6,27
teri,0,0,0,1,1,2
daba,1,1,0,1,2,5
tortillard,0,0,0,1,1,2
possibilities,1,0,1,0,1,3
jalousie,1,1,0,0,1,3
entrambi,0,0,0,1,0,1
dholna,0,0,0,2,0,2
distinto,1,1,0,1,1,4
corvez,1,0,0,1,0,2
begun,3,3,2,3,3,14
obsession,3,3,1,3,3,13
sunrise,3,3,1,0,4,11
plans,1,0,0,0,1,2
pokia,1,1,1,1,1,5
factory,3,0,1,3,2,9
vincennes,1,1,1,1,1,5
notausgang,1,0,1,1,1,4
clover,1,1,0,1,1,4
theory,1,0,0,1,1,3
froufrou,0,0,0,1,1,2
satanic,1,0,0,1,0,2
adiosborron,1,0,0,0,1,2
mouvman,1,1,0,1,1,4
charme,1,1,0,1,1,4
gusta,0,0,0,1,1,2
subzero,1,0,0,0,0,1
turu,0,0,0,0,1,1
motion,5,4,0,5,5,19
turn,13,6,7,12,13,51
butterflies,1,0,1,1,1,4
place,9,6,5,8,6,34
swing,3,5,0,3,3,14
unchanging,1,0,1,0,1,3
sanchez,1,1,0,2,1,5
closers,1,0,1,0,1,3
barsanova,1,1,0,0,1,3
sevillanas,0,0,0,0,2,2
given,1,0,1,0,0,2
opus,1,0,0,1,0,2
uupeemmt,1,0,0,1,1,3
carbonate,0,0,0,1,1,2
bennington,0,1,0,0,1,2
plastic,4,4,3,6,5,22
cooling,1,1,1,1,0,4
waari,1,0,0,0,0,1
woodcarver,1,1,0,1,1,4
white,12,4,6,8,13,43
siciliano,1,0,1,0,0,2
dannys,1,1,1,1,1,5
season,2,0,0,1,1,4
alap,1,1,0,1,1,4
released,1,0,0,1,1,3
soulcrusher,1,1,1,1,1,5
shirley,1,0,0,0,1,2
immigrant,1,1,1,0,1,4
wide,2,0,2,0,2,6
sert,1,0,0,0,1,2
controlando,0,0,0,0,1,1
legacy,1,1,1,1,0,4
sera,0,0,0,0,1,1
cards,1,0,0,0,1,2
oath,2,0,0,1,0,3
searchers,0,1,0,0,1,2
hotstepper,0,0,0,2,2,4
violet,1,0,0,0,0,1
ammohostos,0,0,0,0,1,1
scarifice,0,1,0,0,1,2
quartier,0,1,0,1,0,2
mater,1,0,0,0,0,1
superman,2,0,1,1,2,6
prosperity,1,0,0,0,0,1
clamamus,1,0,1,0,0,2
ideas,2,0,1,1,1,5
nazareth,1,1,0,0,1,3
andante,3,1,0,2,1,7
armando,0,1,0,0,1,2
pardesi,0,0,0,1,1,2
betrayal,1,1,0,0,1,3
falls,4,1,3,3,1,12
bluebird,1,1,0,1,1,4
foundit,1,1,0,1,1,4
proud,2,0,1,0,1,4
hungry,1,1,0,1,1,4
chanteur,1,1,0,1,1,4
hear,11,4,4,6,6,31
catalyst,1,0,1,1,1,4
spaced,0,0,0,1,1,2
tron,1,1,0,1,0,3
perca,1,1,1,0,0,3
futurenow,1,0,1,0,0,2
recipe,1,1,1,1,1,5
spacer,1,0,1,1,1,4
spaces,1,0,0,1,0,2
hack,1,1,1,1,1,5
hace,1,0,1,0,1,3
trop,1,0,1,1,0,3
genius,2,1,2,1,1,7
piranha,1,1,1,0,1,4
crime,1,0,0,0,1,2
nadie,1,1,1,2,2,7
wood,1,1,0,1,1,4
believing,1,0,0,0,1,2
termometro,0,0,0,0,1,1
toca,0,0,0,1,1,2
vekov,1,0,0,1,0,2
raccolto,0,1,0,0,0,1
closure,1,0,0,1,0,2
aranero,1,0,0,0,0,1
doble,0,0,0,0,1,1
naked,2,2,2,0,2,8
clowns,1,0,1,0,0,2
blessure,0,1,0,1,0,2
turntable,0,0,0,1,0,1
parking,1,1,0,0,1,3
heavy,2,0,1,3,2,8
minner,0,1,0,0,0,1
encouraged,0,0,0,1,0,1
farmers,1,0,0,0,0,1
ways,6,3,2,4,4,19
amen,1,1,1,1,1,5
weapons,0,0,0,1,0,1
outside,2,2,1,0,2,7
arrival,1,1,0,1,0,3
tania,0,2,0,2,0,4
fearless,0,0,0,0,1,1
guitar,1,2,1,2,1,7
erde,1,1,0,1,1,4
como,4,3,1,4,5,17
glck,1,1,0,1,1,4
coma,0,1,0,1,1,3
cities,2,0,1,1,1,5
come,48,24,16,25,40,153
superstar,3,1,2,2,3,11
sanddollars,1,0,1,1,1,4
jericho,2,0,0,1,1,4
quiet,2,6,0,1,5,14
xstatic,1,0,1,0,1,3
railway,1,1,1,1,1,5
groundhog,1,1,1,1,0,4
color,1,2,1,2,0,6
trio,2,1,1,1,0,5
satisfaction,1,1,1,1,1,5
skeletons,1,1,1,1,1,5
runaway,1,1,1,1,1,5
turkey,1,0,1,0,0,2
lifes,2,1,2,2,1,8
peaceful,1,0,0,0,0,1
featuring,16,9,4,12,22,63
hardly,3,1,1,2,3,10
engine,1,0,0,0,0,1
direction,1,0,1,0,0,2
blessing,2,1,0,2,1,6
mariposa,1,1,0,0,0,2
valija,1,0,0,0,0,1
tiger,1,0,0,1,0,2
wcss,1,1,0,1,1,4
minister,0,1,0,0,1,2
timbaland,2,0,0,0,2,4
careful,2,2,1,1,1,7
spirit,3,3,3,7,2,18
case,1,0,1,1,1,4
myself,5,5,2,4,5,21
besame,1,0,0,1,1,3
averno,1,0,0,1,1,3
janies,1,1,1,0,1,4
arnold,1,1,0,0,0,2
sutisuti,1,1,0,1,1,4
crusader,1,0,1,1,0,3
ayudame,0,0,0,0,1,1
devereux,0,0,0,0,2,2
svengalis,1,1,1,1,1,5
telephone,1,1,0,0,0,2
numba,0,0,0,0,1,1
good,38,21,12,19,29,119
zhui,0,0,0,0,2,2
volition,1,1,1,0,1,4
mccomb,0,1,0,0,1,2
alphabet,1,0,0,0,1,2
granted,1,0,1,1,1,4
admit,1,0,0,1,0,2
bown,1,0,0,1,1,3
trip,3,1,3,3,2,12
ethiopia,1,0,0,1,1,3
manila,1,1,0,1,1,4
isla,1,0,0,1,1,3
shifty,1,0,1,1,1,4
isle,1,0,0,2,2,5
todos,0,0,0,0,1,1
week,1,0,1,0,0,2
palmas,1,1,0,1,1,4
applaud,1,0,1,0,0,2
nest,2,1,2,3,1,9
driver,2,1,1,0,1,5
drives,1,0,0,0,0,1
weed,2,1,2,1,0,6
submarines,1,1,1,1,1,5
petticoat,1,0,0,0,0,1
rocknroll,1,0,1,0,1,3
innsmouth,1,1,1,1,1,5
changing,1,0,0,0,1,2
weep,1,1,0,1,1,4
jonage,0,1,0,0,1,2
caliente,1,0,0,2,1,4
without,8,2,3,4,9,26
model,2,1,0,0,1,4
vandit,1,1,0,1,1,4
bodies,0,0,0,1,0,1
guided,1,0,0,1,0,2
evenfall,1,0,0,0,0,1
dahlback,1,0,0,0,0,1
actress,1,1,1,1,1,5
pariah,1,0,0,0,1,2
kill,9,1,1,5,5,21
satin,2,3,1,1,2,9
blow,1,1,0,1,1,4
samba,6,9,1,2,6,24
invictus,1,1,0,1,0,3
rose,6,2,1,2,6,17
shadrach,2,2,2,2,2,10
rosa,1,1,1,1,2,6
wall,1,1,0,0,1,3
lets,14,6,2,10,10,42
flashing,0,0,0,1,1,2
donizetti,0,0,0,0,2,2
ross,1,0,0,0,1,2
kingdom,5,2,2,2,5,16
kills,1,0,1,1,0,3
easily,1,0,1,1,1,4
crustaceans,1,0,0,1,1,3
motherinlaw,1,0,1,1,1,4
tanto,1,0,1,0,1,3
standstill,1,0,0,0,1,2
chiornie,1,0,0,1,0,2
irgendwann,1,0,0,1,1,3
resurrectionem,0,0,0,1,0,1
lardechoise,0,0,0,0,1,1
sanity,0,0,0,0,1,1
beothuck,1,0,1,0,0,2
eternity,2,0,2,2,1,7
joking,1,0,1,1,1,4
miel,0,1,0,0,0,1
pacific,1,1,0,1,1,4
respect,0,0,0,0,1,1
caribbean,1,0,0,1,1,3
mood,4,4,2,3,3,16
dunbar,0,0,0,0,1,1
eleanor,1,0,1,0,2,4
legal,1,0,1,0,1,3
moon,14,10,3,11,8,46
namibia,0,0,0,0,1,1
brivido,1,0,0,1,0,2
freed,1,1,0,1,1,4
tiene,3,3,1,3,3,13
poem,1,0,0,0,1,2
dicen,1,1,0,0,1,3
arrivederci,1,1,0,1,1,4
dices,0,0,0,1,1,2
venite,0,0,0,0,1,1
resurrection,2,2,2,2,1,9
improvisation,1,1,0,3,1,6
gendarme,1,0,0,1,1,3
stand,11,5,4,5,12,37
doze,2,0,1,1,1,5
cudi,1,0,0,0,1,2
amber,1,0,0,0,1,2
tribe,0,0,0,1,0,1
ladies,4,3,0,1,4,12
jian,0,0,0,0,2,2
timbuctu,0,1,1,1,0,3
allireland,1,0,0,1,0,2
worldfor,1,0,0,0,1,2
rising,3,1,3,3,2,12
gary,1,1,1,1,0,4
burton,1,0,0,0,0,1
mental,2,1,2,2,2,9
banho,1,1,0,1,0,3
backwater,1,1,0,1,1,4
there,15,10,7,9,14,55
gesagt,1,0,1,0,1,3
valley,3,1,1,1,3,9
pptes,1,0,0,1,1,3
vicente,1,1,0,1,0,3
poet,1,0,0,0,1,2
pygmies,1,0,1,1,1,4
terminus,1,0,1,1,1,4
glopes,1,1,0,1,0,3
feuer,0,0,0,1,0,1
beloki,1,1,0,1,1,4
sleazy,1,0,0,0,1,2
grass,2,1,0,2,2,7
usted,0,0,0,0,1,1
taylor,1,1,0,1,1,4
toiles,1,1,1,0,1,4
taste,3,1,1,2,2,9
feliz,2,1,1,2,1,7
intro,19,11,11,13,16,70
politics,2,1,2,2,1,8
norrskensdd,1,0,0,1,1,3
bishop,1,1,0,1,0,3
abyss,1,0,0,1,0,2
fiddles,0,1,0,0,1,2
fiddler,0,1,0,1,0,2
heather,1,0,1,1,1,4
piracy,0,0,0,0,1,1
rosen,1,1,1,1,1,5
rubber,0,0,0,1,0,1
roses,3,1,3,2,3,12
besos,2,0,1,2,2,7
frydenlund,0,1,0,1,0,2
trash,1,0,1,0,0,2
babylon,2,3,1,1,1,8
ouachita,1,0,0,0,0,1
songz,0,0,0,0,1,1
separate,1,0,0,0,0,1
finale,1,1,0,1,1,4
bobbys,1,0,1,0,1,3
bullets,1,1,0,0,1,3
booked,0,0,0,1,0,1
barcelona,1,1,0,1,1,4
curvy,1,0,1,1,1,4
calla,0,0,0,0,1,1
diss,1,0,1,1,1,4
transesdimanche,1,1,0,1,1,4
epipen,1,0,0,1,1,3
gerlander,1,0,0,1,1,3
fuego,1,0,0,1,1,3
dish,1,0,1,1,2,5
follow,3,2,1,2,3,11
everyones,2,1,0,1,2,6
glimpse,1,0,0,0,0,1
thursday,1,0,0,0,1,2
maleficia,1,0,0,0,1,2
vazo,0,0,0,0,1,1
painter,1,3,0,3,0,7
kvar,0,0,0,1,0,1
presentation,0,5,0,5,5,15
woman,35,27,11,11,19,103
sone,0,0,0,0,1,1
song,54,28,26,32,51,191
sono,2,1,0,0,2,5
sons,1,0,0,0,1,2
sony,1,1,0,1,1,4
ticket,1,0,1,0,1,3
appassionato,1,1,0,1,1,4
porgy,1,1,0,1,1,4
synths,1,1,0,1,0,3
lillie,1,0,1,0,1,3
wreverb,1,1,0,0,1,3
vibes,1,1,0,0,0,2
sergent,0,0,0,1,1,2
saxophone,1,0,0,0,0,1
lisa,1,0,0,0,0,1
escuchame,0,0,0,1,1,2
rats,2,0,2,2,0,6
design,1,0,0,1,0,2
oddisee,1,0,0,1,0,2
chega,1,1,0,1,1,4
jeremiah,1,0,0,0,1,2
ticky,1,0,0,0,1,2
what,52,30,27,30,39,178
hesitation,1,1,1,1,0,4
circumstance,1,1,1,0,1,4
rascal,1,0,0,0,0,1
anniversary,1,1,0,2,2,6
crush,1,1,0,1,0,3
version,609,256,290,291,523,1969
guns,1,1,1,0,1,4
racine,0,0,0,1,0,1
vamos,1,0,1,1,1,4
tagu,1,1,1,1,1,5
yksinisin,0,0,0,0,1,1
nene,1,1,0,0,1,3
fugue,5,0,0,5,5,15
nena,1,0,1,0,1,3
theresa,1,0,0,1,0,2
dedicado,0,0,0,0,1,1
directions,1,1,0,1,1,4
tragedy,3,1,1,2,2,9
cappella,1,1,0,1,0,3
naval,0,0,0,1,0,1
chale,1,1,1,1,1,5
matanza,1,0,1,0,1,3
agustin,1,1,1,1,1,5
members,0,0,0,1,0,1
palabras,1,0,0,0,1,2
solitude,1,0,1,0,1,3
florence,0,0,0,1,0,1
tutto,0,0,0,1,0,1
marashi,0,1,0,0,0,1
quiser,1,0,0,0,1,2
minor,5,2,0,3,3,13
flat,2,0,1,1,2,6
flaw,1,1,0,0,1,3
flav,0,0,0,0,1,1
knows,2,1,1,3,2,9
oboe,1,0,0,1,1,3
mira,0,0,0,0,1,1
floyd,1,1,0,0,0,2
stick,1,0,1,1,0,3
known,1,1,0,0,0,2
mellow,0,1,0,0,0,1
glad,2,0,2,2,3,9
verano,1,0,1,0,1,3
zeichen,0,0,0,0,1,1
ethno,1,0,1,1,1,4
eden,1,0,1,1,0,3
crossbreed,0,0,0,1,0,1
amdokwe,1,1,0,1,1,4
pero,1,1,0,1,1,4
excursion,1,0,0,1,0,2
janices,1,0,1,0,1,3
pony,1,2,0,0,2,5
erzhlt,0,1,0,1,0,2
azul,0,1,0,1,1,3
wycombe,1,0,0,1,1,3
metamorphosis,1,1,0,2,0,4
arise,0,0,0,0,1,1
pong,1,0,0,0,1,2
slarta,0,1,0,1,1,3
court,1,1,0,1,0,3
chaco,0,1,0,0,1,2
rather,1,0,0,1,1,3
breaking,4,3,2,4,5,18
cleansing,1,0,2,0,0,3
punkrock,1,0,1,0,0,2
musica,1,4,0,4,0,9
buenos,1,0,0,0,1,2
dreada,0,0,0,1,0,1
simplicity,3,0,0,3,3,9
sandwich,1,0,1,0,0,2
okay,0,0,0,1,1,2
ballade,1,0,0,0,1,2
fungus,1,0,1,1,1,4
adventure,2,2,2,3,2,11
numb,1,1,0,1,1,4
short,1,0,0,0,1,2
susan,1,0,0,0,1,2
dorma,1,0,0,1,0,2
shore,0,0,0,1,1,2
grande,2,2,0,0,2,6
shade,2,1,0,2,2,7
grandi,0,1,1,1,0,3
xuan,1,1,0,1,1,4
soldats,1,1,1,1,1,5
emmanuel,2,0,1,1,2,6
mission,3,0,0,1,3,7
chacacha,0,0,0,1,1,2
isnt,3,2,2,1,3,11
alamadalah,0,0,1,1,1,3
avenue,2,1,0,1,1,5
style,3,1,2,2,4,12
pray,4,2,1,3,1,11
praz,0,0,0,1,0,1
beyonce,1,1,0,0,1,3
abbey,1,0,1,1,1,4
parts,1,0,1,0,0,2
conformist,1,0,1,1,1,4
rette,1,1,0,1,1,4
bout,3,2,2,2,2,11
might,1,0,1,1,1,4
alter,1,1,1,1,1,5
somebody,6,4,3,5,6,24
botellas,1,0,0,1,0,2
abacua,1,1,0,1,1,4
hunter,5,3,2,2,5,17
speechless,1,0,0,1,1,3
hunted,1,1,1,1,1,5
marcus,0,0,0,0,1,1
gets,1,1,0,0,1,3
leli,1,0,1,0,0,2
disciple,1,0,1,1,1,4
inherent,1,1,0,0,0,2
mulin,0,1,0,0,0,1
flunkadelic,0,1,0,1,1,3
weight,2,0,2,1,2,7
generation,4,0,1,1,1,7
oppressed,1,0,0,0,0,1
hawaii,1,0,1,0,0,2
jakwob,0,0,0,1,1,2
decline,1,0,0,0,0,1
clandestino,1,0,0,0,1,2
lole,0,0,0,1,0,1
nuovo,1,0,1,1,1,4
disquiet,0,0,1,0,0,1
hydraulic,0,0,0,1,0,1
hill,5,4,2,5,6,22
comme,4,2,0,2,4,12
paradise,4,2,0,1,2,9
soulless,1,0,0,1,0,2
exodus,2,1,0,1,2,6
friday,1,0,1,1,0,3
forgive,0,1,0,0,0,1
denfants,1,0,1,1,1,4
teach,1,1,0,0,1,3
kyotronics,0,0,0,1,0,1
sylvester,1,0,0,1,0,2
stampede,1,0,1,1,0,3
shonoda,0,1,0,0,1,2
deja,1,0,0,0,1,2
fallen,1,0,1,0,0,2
vuelve,0,0,0,1,1,2
feed,0,0,0,1,0,1
feel,10,7,4,8,9,38
defecto,1,0,1,1,1,4
pork,1,0,1,0,0,2
fancy,0,0,0,1,0,1
feet,2,1,0,2,1,6
sympathy,2,1,0,1,1,5
notify,1,0,1,1,1,4
blank,1,1,1,1,0,4
invader,0,0,0,1,1,2
blanc,0,0,0,0,1,1
moan,0,1,0,0,0,1
story,8,5,2,4,11,30
breathless,1,0,1,1,0,3
passez,1,1,0,1,1,4
beibi,1,0,1,1,1,4
nian,1,1,0,1,1,4
storm,4,1,1,0,1,7
stora,1,0,0,0,0,1
vuelvo,1,0,1,0,1,3
headache,1,0,0,1,1,3
qbert,0,1,0,0,1,2
segue,1,0,0,0,0,1
clowngood,1,0,1,0,1,3
hotel,2,1,0,1,1,5
king,14,9,3,10,13,49
kind,8,6,4,7,9,34
double,0,0,0,1,0,1
dans,3,3,2,3,4,15
medicate,1,1,1,1,1,5
prairie,1,1,0,1,1,4
seamos,1,0,0,0,1,2
dani,1,0,1,0,1,3
dang,0,0,0,1,0,1
saxambando,0,1,0,1,0,2
dana,0,1,0,0,1,2
entellina,0,1,0,1,0,2
tongues,1,0,0,0,1,2
djemba,0,2,0,0,0,2
garfield,1,0,1,1,1,4
motindo,1,1,0,1,1,4
fiona,1,1,1,0,1,4
oriole,1,0,0,0,1,2
pieni,1,1,0,1,1,4
hopelessly,2,0,1,0,1,4
nights,5,2,3,1,4,15
port,1,0,0,1,1,3
maison,0,1,1,2,1,5
finding,0,1,0,0,0,1
needle,1,0,1,1,1,4
electric,3,2,0,4,3,12
kardinal,0,1,0,0,1,2
reach,3,0,3,3,1,10
cigarette,4,3,1,1,2,11
amar,1,0,0,2,2,5
nothing,13,8,8,9,8,46
seasons,1,2,0,1,0,4
doggin,2,1,0,0,0,3
windows,1,0,1,1,1,4
cordeiro,1,1,0,0,0,2
wichita,2,1,0,2,2,7
traditional,0,1,0,0,1,2
journeys,1,0,0,0,0,1
pennies,0,0,0,0,1,1
grandmas,0,0,0,1,1,2
fonc,1,0,0,1,1,3
jambalaya,2,0,0,1,1,4
stoned,1,1,1,0,0,3
melody,3,4,2,3,4,16
nuevo,0,0,0,0,1,1
cried,3,2,1,3,3,12
enfinsombre,1,0,0,0,1,2
jazz,3,5,0,3,4,15
intermezzo,1,0,0,1,1,3
moses,1,0,0,0,1,2
lavabo,1,0,1,1,1,4
porque,1,0,0,2,4,7
hablando,1,0,1,1,1,4
triangle,1,0,0,0,1,2
meditations,1,2,0,0,0,3
maailma,1,1,0,1,1,4
whistle,2,2,0,1,2,7
mortuum,0,0,0,0,1,1
rafaqat,0,0,1,1,1,3
budapest,1,1,0,1,1,4
percutindo,0,0,1,0,0,1
bolena,1,0,0,1,0,2
rinaldo,4,0,0,0,4,8
catharsis,1,0,0,0,0,1
orgofart,1,0,0,0,1,2
wheeling,1,1,0,1,1,4
wrote,1,0,1,1,1,4
regresas,0,1,0,0,1,2
dump,3,0,0,0,0,3
fuoco,0,1,0,0,0,1
wanderin,1,1,1,1,1,5
dumy,1,0,0,0,0,1
bare,0,0,0,1,1,2
bari,0,1,0,1,0,2
matin,1,0,1,1,1,4
einfach,1,0,0,0,0,1
romances,1,1,0,0,0,2
barn,1,0,0,1,1,3
recording,1,0,0,0,1,2
crushing,1,0,0,0,0,1
klut,1,0,0,0,0,1
klux,1,1,0,0,1,3
watchie,0,0,0,2,0,2
contrary,1,0,0,0,0,1
femmes,4,3,1,4,4,16
supposed,1,0,1,1,0,3
solo,6,4,3,5,4,22
latin,1,2,0,2,1,6
sola,0,1,0,0,0,1
atrs,1,0,1,1,1,4
prelude,3,0,2,3,2,10
lyrical,1,0,0,1,0,2
riddles,1,1,0,1,1,4
breakin,5,3,1,3,4,16
bandit,1,0,0,0,0,1
roman,1,1,0,0,0,2
became,1,0,0,1,0,2
baseball,1,1,0,0,0,2
samjho,0,0,0,1,0,1
alegria,0,1,0,0,0,1
mhle,0,0,0,1,1,2
rubbers,0,0,0,1,0,1
camio,1,0,0,1,1,3
sweet,16,9,5,12,14,56
sweep,0,0,1,0,0,1
lbas,1,0,0,1,1,3
ranchera,1,1,0,1,1,4
village,2,3,1,1,2,9
rave,1,0,0,1,1,3
ranchero,1,1,0,1,1,4
alkaholiks,0,0,0,1,0,1
akkarai,0,0,0,1,0,1
java,1,1,1,2,3,8
sehnsuchtsexpress,1,1,0,1,1,4
whos,1,0,0,0,0,1
wraparound,0,0,1,0,0,1
guitarra,0,0,0,0,1,1
nicol,1,1,1,1,1,5
pinini,1,1,1,1,0,4
woke,1,1,0,1,1,4
nehi,0,1,0,0,0,1
flight,4,2,1,2,1,10
panadera,1,0,0,0,0,1
demand,2,2,1,2,1,8
rocking,2,2,0,0,2,6
marche,1,0,0,1,1,3
stolen,2,1,0,1,2,6
acuerdo,2,1,1,1,2,7
theres,1,0,1,3,1,6
espacio,1,0,0,0,1,2
demon,1,0,1,0,1,3
demos,1,0,1,0,0,2
awakening,1,0,0,1,0,2
currents,1,1,0,1,1,4
blackwood,1,1,0,1,0,3
chestnuts,1,1,0,1,0,3
cannonballs,1,0,1,1,1,4
electrasonic,1,1,0,0,0,2
viola,1,2,0,0,1,4
daughters,1,0,0,0,1,2
higher,1,0,0,0,1,2
warum,1,0,0,1,1,3
cartridge,1,0,0,0,1,2
revolucin,1,1,0,0,1,3
arrived,1,0,1,1,1,4
birch,1,1,1,1,1,5
byal,1,1,0,0,1,3
spaceman,1,0,1,0,1,3
abilene,1,0,0,0,1,2
anybody,1,1,1,1,1,5
cheer,1,1,0,0,2,4
edge,6,3,3,1,5,18
know,32,15,14,19,28,108
sjlslig,1,0,0,1,0,2
questions,1,1,1,1,1,5
cabaret,2,1,1,2,1,7
prince,1,0,0,2,0,3
lioraras,1,1,1,1,1,5
tables,1,1,0,1,1,4
christlike,1,1,0,0,1,3
acapella,1,0,1,2,1,5
hsin,1,0,1,1,1,4
rossignol,1,1,0,0,1,3
vendor,0,1,0,0,0,1
amended,13,4,3,5,14,39
awakes,1,0,0,0,0,1
procuration,1,0,0,1,1,3
bleibt,1,1,0,1,1,4
maracaia,0,0,0,1,1,2
unlimited,2,2,2,2,2,10
sharpener,1,1,0,1,1,4
lovin,9,6,4,4,7,30
volver,1,0,0,1,1,3
awaken,1,0,1,1,1,4
socialgrupp,0,0,0,1,0,1
sencillamente,1,0,1,1,1,4
message,3,3,2,0,1,9
incidental,2,2,0,2,0,6
arthur,1,0,0,1,1,3
essential,1,0,0,0,0,1
waitin,1,1,1,1,2,6
fucking,1,0,0,0,0,1
understood,1,0,0,0,1,2
marmalade,0,1,0,0,1,2
spontanous,1,1,0,1,1,4
clown,0,0,0,1,1,2
wonderland,1,2,0,3,2,8
nachts,0,0,0,0,1,1
wanderlust,1,0,0,0,1,2
rien,4,3,2,3,4,16
lizzy,1,0,0,0,0,1
conmigoperdoname,0,0,0,0,1,1
erotas,0,0,1,0,1,2
lappi,1,0,0,0,1,2
rituals,1,0,0,0,1,2
tends,1,0,1,1,1,4
ojos,4,1,2,3,6,16
fragments,1,1,0,1,0,3
prod,2,0,0,0,2,4
anna,1,0,0,1,0,2
queremos,0,0,0,1,1,2
sheng,0,0,0,1,3,4
palmer,1,0,0,1,1,3
faute,1,0,1,1,1,4
savoir,1,1,1,1,1,5
egine,1,0,0,0,1,2
soando,0,1,0,0,0,1
nueva,1,0,0,0,1,2
decidete,1,0,0,0,1,2
qing,0,0,0,0,2,2
undertow,2,0,1,0,1,4
cranford,2,0,0,0,2,4
kabhi,0,0,0,1,0,1
violins,1,0,1,1,1,4
lifeless,1,1,0,1,0,3
militia,1,0,1,0,1,3
serenata,1,1,0,0,2,4
dialog,1,1,0,0,1,3
hatred,1,0,1,1,0,3
womens,1,1,1,1,1,5
wanna,13,7,9,9,8,46
bleeds,2,0,0,0,2,4
fantasie,1,0,0,1,1,3
johns,1,1,0,0,0,2
shed,1,1,0,0,0,2
drifter,1,1,0,1,1,4
momma,0,0,0,1,1,2
because,6,4,2,3,5,20
gavel,1,1,0,1,1,4
danote,1,0,0,1,0,2
damiti,0,1,0,0,1,2
rubor,1,1,0,1,1,4
canal,0,1,0,0,1,2
janam,0,0,1,1,0,2
bruv,1,0,1,0,0,2
cobardes,0,1,0,1,1,3
question,5,2,2,2,5,16
long,28,15,10,17,26,96
brun,0,1,0,0,0,1
alfredovioletta,1,0,0,1,0,2
summertime,1,1,0,0,1,3
todas,1,1,0,0,0,2
vienna,1,0,1,0,1,3
mountains,3,1,2,2,3,11
melodia,2,1,0,2,2,7
prez,0,1,0,1,0,2
girlfriends,1,0,1,0,1,3
junior,1,1,0,0,0,2
raising,0,0,1,0,0,1
commercialism,1,1,0,0,1,3
calles,1,1,1,1,1,5
fries,2,2,0,0,2,6
peppermint,1,1,1,1,1,5
suckin,1,0,0,1,1,3
fica,0,0,0,1,0,1
pres,1,0,1,1,1,4
sosla,1,1,0,1,1,4
fried,2,2,0,1,2,7
called,3,1,2,2,3,11
deliverance,1,0,0,0,1,2
tuman,1,0,0,1,0,2
freak,2,1,2,4,2,11
mosiah,0,0,0,0,1,1
warning,1,0,1,1,1,4
home,31,19,14,15,26,105
rainbow,12,10,4,8,10,44
garonnire,0,0,0,1,1,2
rains,0,0,1,0,0,1
peace,5,6,3,8,5,27
backs,1,1,0,1,0,3
cuenta,2,1,1,1,2,7
towers,1,0,1,0,0,2
hannikaisen,1,0,0,1,1,3
nice,5,4,3,3,4,19
mythodea,1,0,0,1,1,3
noche,2,1,1,1,1,6
missin,1,1,0,0,1,3
problems,2,1,2,3,2,10
divum,0,0,0,0,1,1
pasajera,1,0,0,1,1,3
meaning,1,0,1,1,1,4
vigil,1,0,0,0,1,2
posters,0,1,1,0,0,2
kookosphkin,1,1,0,1,1,4
remix,59,29,24,50,50,212
raketen,1,1,1,1,1,5
lead,2,0,2,1,2,7
dropsonde,1,0,1,1,0,3
sostenuto,0,0,0,0,1,1
afonsina,0,0,0,1,1,2
nasa,1,0,0,1,1,3
karma,2,1,1,1,2,7
narrative,2,0,0,0,2,4
once,2,0,0,0,2,4
mardi,2,2,0,0,2,6
resistance,2,0,1,1,2,6
alien,1,1,1,1,1,5
windy,1,0,0,0,1,2
jimi,1,0,0,0,1,2
winds,1,0,1,1,1,4
ramuka,1,1,0,1,0,3
fotia,1,0,0,0,1,2
cruiser,0,1,0,1,0,2
xxii,1,0,0,1,1,3
coloness,1,0,0,1,1,3
itll,1,0,0,1,0,2
ultraviolence,1,0,1,1,0,3
dandy,1,0,0,0,0,1
hellnd,0,0,1,0,0,1
revitalise,1,1,1,1,1,5
gina,1,1,1,1,1,5
spoon,2,0,1,2,2,7
akhm,1,0,0,0,0,1
sheds,0,1,0,1,0,2
drinking,2,2,0,1,1,6
aattelepa,1,0,0,1,1,3
zeit,1,1,1,2,1,6
pluvialus,1,0,0,1,0,2
melodies,1,0,0,0,1,2
pleas,1,0,0,0,0,1
someday,6,4,1,3,4,18
procession,1,0,0,1,1,3
tumblin,3,2,1,1,1,8
ostravaczech,1,1,1,0,1,4
fold,0,0,0,1,0,1
gaurant,0,1,1,0,0,2
traveling,1,1,0,0,0,2
reunion,2,1,0,1,2,6
acid,1,1,0,1,1,4
waiting,12,6,4,7,11,40
capitan,1,1,0,0,1,3
ammunition,1,0,0,0,1,2
lgrimas,1,0,0,0,1,2
forains,1,1,1,1,1,5
desires,1,0,0,0,1,2
kangaroo,2,0,0,1,1,4
pushing,1,0,1,0,0,2
sexo,1,0,0,0,1,2
phantoms,1,0,0,0,0,1
separation,2,0,2,2,2,8
sexy,1,1,0,1,2,5
headsprung,1,0,0,0,1,2
miser,1,0,1,0,0,2
yueh,0,1,0,0,1,2
larger,1,0,0,0,1,2
shades,0,0,1,1,0,2
leaving,1,1,0,2,0,4
headless,0,1,0,0,0,1
cokane,1,1,0,0,1,3
olivier,0,0,0,1,0,1
breeds,1,0,0,0,0,1
shovel,0,0,0,1,0,1
apple,2,1,0,0,2,5
harda,1,0,0,0,0,1
tatz,1,0,0,1,1,3
duck,1,0,1,0,1,3
dubrovnic,1,1,0,0,1,3
yannick,1,0,0,1,1,3
from,65,37,27,27,48,204
hears,1,0,0,0,0,1
escuta,0,1,0,0,0,1
quitxalla,1,0,1,1,1,4
frog,1,1,0,0,1,3
pura,1,1,0,0,1,3
staxhigh,0,1,0,0,1,2
wayne,1,0,0,0,0,1
eagles,1,1,1,0,1,4
clever,4,0,4,4,4,16
dorgue,0,1,0,1,0,2
sors,1,0,0,0,1,2
tienne,0,0,1,1,1,3
chichi,0,1,0,0,0,1
heim,1,0,0,0,0,1
taevas,1,0,0,1,0,2
porcs,1,1,0,0,1,3
women,1,0,0,1,1,3
disingenuous,1,1,0,1,0,3
evenglow,0,0,0,1,0,1
anywhere,2,0,0,1,2,5
pedagogy,1,0,0,0,0,1
proof,1,1,1,1,1,5
thirsty,2,1,2,2,1,8
cierra,0,0,0,0,1,1
raggle,1,1,0,0,1,3
faceplant,1,0,1,1,1,4
something,8,6,3,6,8,31
rape,2,0,0,0,0,2
summers,1,1,1,1,1,5
united,1,0,0,0,0,1
syndrome,1,1,1,1,1,5
guru,0,0,0,1,0,1
parlour,0,0,0,1,0,1
fortunate,2,0,1,0,2,5
prognosis,1,1,0,1,0,3
chre,1,0,0,1,1,3
bark,1,0,0,0,0,1
instead,0,1,0,0,0,1
panic,1,0,1,0,1,3
memoir,1,0,0,1,0,2
gallo,1,1,0,0,0,2
dominion,1,0,0,0,0,1
komor,1,0,1,1,1,4
psychedelia,1,0,1,1,1,4
rollercoasting,1,0,1,1,1,4
somethin,2,1,2,1,1,7
tanzen,1,1,1,1,1,5
montmartrois,1,1,0,0,1,3
soleil,1,1,0,1,1,4
light,18,7,10,14,16,65
liian,1,0,0,1,1,3
windpower,2,2,2,2,2,10
crawling,2,1,1,1,1,6
necklace,1,1,1,1,1,5
jolie,0,1,0,0,0,1
marlowe,1,0,1,1,0,3
mafu,0,1,0,0,0,1
complicate,1,0,0,0,1,2
glee,0,0,1,0,0,1
ships,1,1,1,0,1,4
nostalgia,1,0,0,1,1,3
myasorubka,1,0,0,1,0,2
primordial,1,0,0,0,0,1
choose,1,0,1,1,1,4
orange,2,0,2,2,0,6
covered,1,0,0,1,1,3
holiday,0,0,0,1,1,2
jukebox,1,1,1,1,1,5
trows,1,0,0,1,0,2
planxty,0,0,0,0,1,1
bumbling,1,1,0,1,1,4
crash,3,1,0,0,1,5
practice,1,1,0,1,1,4
emerald,1,0,1,1,1,4
seas,1,0,0,0,1,2
sinners,0,0,0,1,0,1
trad,1,0,0,1,1,3
tratre,1,0,1,1,1,4
profound,1,0,1,1,0,3
edit,16,13,11,20,15,75
youmore,1,1,0,1,1,4
trak,1,1,1,1,0,4
billy,1,1,0,0,1,3
latvia,1,1,0,0,1,3
fiddle,1,1,0,0,0,2
tras,0,1,0,0,0,1
champ,1,1,0,1,0,3
bills,0,1,0,0,0,1
trax,1,0,0,1,0,2
skank,0,0,0,1,0,1
firepower,1,1,0,1,0,3
semen,1,0,0,1,1,3
tabloid,1,1,1,0,1,4
revelator,1,1,1,1,0,4
chaos,2,1,0,2,1,6
tcale,1,1,0,1,1,4
grits,1,0,0,0,0,1
kaur,0,1,0,1,0,2
cornpone,1,1,0,1,1,4
nuit,1,0,0,1,1,3
mississippi,1,1,0,0,0,2
rakkautta,1,1,0,0,1,3
heartbreaker,1,1,0,0,1,3
york,3,4,2,2,3,14
anyhow,1,0,0,1,1,3
llorando,0,0,0,1,2,3
river,9,9,3,8,12,41
cais,1,1,0,1,0,3
spazs,1,0,0,0,1,2
conversation,0,1,0,1,2,4
poderte,0,0,0,1,0,1
adrian,1,0,0,1,0,2
cain,1,0,0,0,1,2
firehouse,1,0,0,1,1,3
echo,1,2,0,0,1,4
probation,0,1,0,0,0,1
bois,1,1,0,0,1,3
coolsville,1,1,1,1,1,5
vino,2,0,0,0,2,4
stephan,0,0,0,1,0,1
inertiatic,1,0,1,1,0,3
neira,1,1,0,1,0,3
shell,1,0,1,0,0,2
acteact,0,1,0,0,0,1
regarde,1,0,1,1,1,4
academy,2,0,2,2,0,6
salzanitos,1,0,1,0,0,2
july,2,1,0,2,2,7
holland,1,1,1,1,1,5
boring,2,0,2,1,1,6
guauqui,0,1,0,0,0,1
banjoreno,0,1,0,0,0,1
carnaval,4,4,0,0,0,8
tommy,1,0,1,1,1,4
lucium,1,0,0,0,0,1
endeka,0,0,0,0,1,1
dynamo,1,1,1,0,1,4
encore,2,2,1,2,1,8
faithkeeper,0,0,0,1,0,1
sonho,0,1,0,0,0,1
yellin,1,0,1,0,1,3
bliv,1,0,0,1,0,2
sarambeque,0,1,0,1,1,3
catholic,1,0,0,0,1,2
afraid,2,1,1,2,2,8
grustnaja,1,1,0,0,0,2
rincn,1,0,1,1,1,4
tariacuri,0,0,0,0,1,1
stormtrooper,1,0,1,0,1,3
martha,1,0,1,0,0,2
criteria,0,0,0,0,1,1
clash,2,2,2,2,2,10
centre,1,0,1,0,0,2
cracking,1,0,1,0,0,2
lidole,1,0,1,1,1,4
class,3,2,3,2,2,12
spirits,0,1,0,1,0,2
polyester,1,1,1,1,1,5
mistadobalina,1,1,1,1,1,5
pipe,2,0,2,2,0,6
oneerstes,0,1,0,0,0,1
vermes,1,1,1,1,1,5
guinea,1,1,1,1,0,4
weeny,1,0,0,1,1,3
chances,1,1,0,1,1,4
ulan,1,1,1,1,1,5
senegal,0,1,0,0,0,1
perlas,0,1,0,0,0,1
niev,1,1,0,0,1,3
fear,5,3,2,2,3,15
darkest,1,0,1,1,0,3
feat,38,27,16,35,41,157
reminisce,2,1,1,1,1,6
combo,1,0,0,1,1,3
piano,10,5,1,9,8,33
cube,0,0,1,0,0,1
workin,1,2,1,2,1,7
watching,1,1,0,1,1,4
sueo,0,2,0,1,2,5
dope,2,0,1,1,1,5
jorobadito,1,0,0,0,1,2
ones,3,2,1,1,3,10
wigue,1,1,0,1,1,4
tierra,1,0,0,1,1,3
words,6,0,1,2,4,13
burglary,1,0,0,0,0,1
chips,1,0,0,1,1,3
ghetto,2,1,1,2,3,9
heretic,2,0,1,0,1,4
mazhar,0,1,0,1,0,2
kanssain,1,0,0,1,1,3
deceived,2,1,1,1,2,7
viralo,0,1,0,1,0,2
klappert,0,0,0,1,1,2
aqualite,1,0,0,0,1,2
hymnal,0,0,1,0,1,2
uhuhuh,0,1,0,0,0,1
luminous,1,1,0,1,1,4
maries,1,0,0,0,1,2
montalvo,1,1,1,0,1,4
closer,2,1,1,1,1,6
closes,1,0,0,0,1,2
favor,1,0,1,0,0,2
viper,1,0,0,0,1,2
closed,1,0,1,1,1,4
copilot,1,0,1,0,1,3
junko,1,0,0,0,0,1
cola,1,0,1,1,1,4
pants,3,0,1,1,2,7
fagioli,1,0,0,1,1,3
cello,1,1,0,0,0,2
opening,2,0,0,1,0,3
schitzo,1,0,1,1,1,4
lagda,0,0,0,1,0,1
takeover,1,0,0,0,0,1
montmartre,0,0,0,0,1,1
piece,4,2,2,1,3,12
lifeboat,1,1,1,0,0,3
april,2,0,1,1,2,6
diehard,1,0,0,0,0,1
borrare,0,0,0,0,1,1
worldll,0,0,1,0,1,2
wala,0,0,1,1,0,2
tunisia,0,1,0,0,0,1
operawishing,1,0,0,0,1,2
makin,2,2,1,0,1,6
walk,12,10,5,8,10,45
exiliado,1,0,1,1,1,4
table,3,1,1,0,1,6
amigo,2,1,0,0,4,7
golfshirt,1,0,1,1,1,4
boatman,1,1,0,1,1,4
reindeer,1,2,0,2,2,7
mike,1,2,0,0,1,4
skinhead,1,0,0,0,1,2
msicas,1,1,0,0,0,2
crappy,1,0,1,1,1,4
overture,2,2,2,2,1,9
desperados,0,1,0,1,0,2
present,2,0,0,2,0,4
sanctify,1,1,1,1,1,5
choices,0,0,0,0,1,1
will,35,17,15,20,37,124
kommando,1,0,1,1,1,4
headlock,0,0,0,1,1,2
wild,11,7,4,3,8,33
madeleine,1,1,0,1,1,4
happened,1,1,0,0,1,3
bolero,1,1,1,1,1,5
buzzards,1,1,1,1,1,5
boite,1,0,1,1,0,3
duas,0,1,0,0,0,1
thus,0,0,0,1,1,2
konjunkturpaket,1,0,1,1,1,4
guajiro,0,1,0,0,0,1
education,1,1,1,1,1,5
radiation,1,0,1,0,0,2
cross,6,2,3,2,6,19
eschaton,2,0,1,1,1,5
units,1,0,0,1,0,2
lobotomy,1,0,1,1,0,3
hlvenee,1,0,1,1,1,4
parthenon,1,0,1,1,1,4
slave,3,2,1,1,3,10
outcast,1,1,0,1,1,4
beast,4,2,1,1,2,10
cheshire,1,0,0,0,0,1
valerie,2,1,0,0,1,4
tynn,1,0,0,1,1,3
fighting,3,0,1,0,1,5
kuolema,1,0,0,0,1,2
halb,0,0,0,0,1,1
degarmo,1,0,0,0,0,1
english,3,0,2,2,3,10
breaker,1,0,0,1,0,2
chataigniers,0,1,0,0,1,2
rocker,2,0,0,1,1,4
fausse,0,1,0,0,1,2
plombier,0,0,0,1,1,2
rocket,2,2,1,2,2,9
cries,1,1,0,1,0,3
batteries,1,0,1,1,1,4
rachels,1,1,1,1,1,5
herval,0,1,0,0,0,1
fishing,1,1,0,0,1,3
happiness,1,0,1,1,1,4
pendulum,1,0,0,0,1,2
hoppa,1,0,0,1,0,2
supply,1,1,0,1,0,3
smith,1,1,1,0,0,3
dartiste,1,0,0,0,1,2
book,2,2,1,2,2,9
boom,1,0,0,2,1,4
preso,0,1,0,1,0,2
myth,2,1,2,1,2,8
interrogation,0,0,1,1,0,2
darkside,1,1,0,1,1,4
temperedclavier,1,0,0,1,0,2
irreemplazable,1,1,0,0,1,3
megatrend,1,1,0,0,1,3
posttoxic,1,0,0,1,1,3
loses,1,1,0,1,1,4
vortex,1,1,0,1,0,3
tennessee,2,0,2,1,2,7
cutler,1,0,0,1,1,3
viimeiset,1,0,1,1,1,4
iskorosten,1,0,1,0,1,3
wonders,0,0,0,1,0,1
amores,1,1,0,2,3,7
tumble,1,1,0,1,1,4
bequeth,0,0,1,0,1,2
scared,3,2,0,0,3,8
searching,1,1,1,0,1,4
growth,1,0,1,1,0,3
beguine,0,0,0,0,1,1
star,9,6,4,8,8,35
empire,4,3,0,1,2,10
amoren,1,0,0,0,1,2
jeremy,1,1,1,1,0,4
nedle,1,0,1,0,0,2
operation,0,0,0,1,1,2
earrings,1,0,0,0,0,1
leader,2,1,1,0,2,6
ripped,1,0,0,1,1,3
slut,0,0,1,0,1,2
ability,1,0,0,0,1,2
ripper,1,0,1,1,1,4
slum,1,0,0,0,0,1
taggle,1,1,0,0,1,3
supermassive,1,1,1,1,1,5
throne,1,0,1,1,0,3
tyttret,1,0,0,1,0,2
getting,1,1,1,1,0,4
universe,4,3,3,2,4,16
asha,1,1,0,1,1,4
raro,1,1,0,0,0,2
ressusciteront,0,0,0,1,0,1
epiphany,1,0,1,0,1,3
sweat,2,1,2,2,1,8
subida,0,0,0,0,1,1
kanaka,0,0,0,1,1,2
emperor,1,1,1,1,1,5
togshan,0,1,0,1,0,2
weather,5,2,1,0,4,12
promise,1,0,0,1,1,3
invidio,0,0,0,1,0,1
registration,0,2,0,0,0,2
colombine,1,1,0,0,1,3
roadhead,1,0,1,1,1,4
platoon,2,1,0,1,1,5
grapevine,1,0,1,0,1,3
munster,0,0,0,1,0,1
kidding,1,0,1,1,1,4
adelante,0,0,0,1,1,2
shang,0,0,0,0,3,3
bitches,1,0,0,1,0,2
mutter,1,1,0,1,1,4
volume,2,2,0,1,2,7
nassau,1,0,1,0,1,3
made,9,4,4,6,4,27
frukos,0,1,0,1,0,2
mundharmonika,1,1,0,0,1,3
record,3,2,3,1,3,12
below,1,1,1,1,1,5
tema,2,1,0,1,1,5
block,2,0,2,0,0,4
jenny,3,2,2,3,3,13
braucht,1,0,1,1,1,4
kingsize,1,1,0,1,1,4
gleniffer,1,0,0,0,0,1
goodness,0,0,0,1,1,2
brauche,1,0,0,1,1,3
entrada,0,0,0,0,1,1
naming,1,0,1,0,0,2
tranceplant,2,0,0,2,2,6
branco,0,0,0,1,0,1
roars,1,0,0,0,1,2
other,10,2,2,4,5,23
pretinha,1,1,0,1,0,3
sick,1,0,1,2,2,6
coffees,1,0,1,0,1,3
branca,1,1,0,1,0,3
alobi,0,0,1,0,0,1
dhol,0,0,0,2,1,3
junk,1,0,1,1,1,4
juno,1,0,1,1,1,4
airtos,1,1,0,1,1,4
june,2,1,2,2,1,8
jung,1,0,0,1,1,3
apoliome,1,0,0,1,1,3
kinda,1,2,1,1,1,6
rhapsody,1,2,0,1,1,5
spinward,1,1,0,0,0,2
cliff,1,0,0,0,0,1
rotting,1,0,1,0,0,2
bwoy,0,0,0,1,0,1
pode,1,1,1,1,1,5
batallon,0,1,0,0,0,1
lchelns,0,0,0,0,1,1
heidi,0,1,0,0,1,2
allein,1,0,0,1,1,3
aziatic,1,0,0,0,0,1
