"","word","rock","jazz","alternative.rock","electronic","pop","total"
"1","life",41,17,15,25,32,130
"2","love",224,137,97,156,213,827
"3","world",46,37,18,38,37,176
"4","baby",53,33,13,20,31,150
"5","night",46,25,27,32,36,166
"6","heart",44,24,12,29,41,150
"7","time",68,38,28,39,55,228
"8","never",39,20,15,26,32,132
"9","girl",42,17,26,29,40,154
"10","little",48,32,16,26,40,162
"11","woman",35,27,11,11,19,103
